AAAAACTCTTAGTGTAGTA -> AAAACTCTTAGTGTAGTAT
AAAACTCTTAGGGGTACAT -> AAACTCTTAGGGGTACATT
AAAACTCTTAGTGTAGTAT -> AAACTCTTAGTGTAGTATT
AAACAAGACAGTTGGCCGG -> AACAAGACAGTTGGCCGGC
AAACAGCCGAAGGAATTCC -> AACAGCCGAAGGAATTCCG
AAACCCTAAACCGCTCGCA -> AACCCTAAACCGCTCGCAG
AAACCGCAGAGTTCGAGCG -> AACCGCAGAGTTCGAGCGC
AAACCGCTCGCAGAATAAG -> AACCGCTCGCAGAATAAGC
AAACCGCTCGCAGAATCAG -> AACCGCTCGCAGAATCAGG
AAACCGCTCGCAGAATTAT -> AACCGCTCGCAGAATTATC
AAACCGCTCGCAGAATTGT -> AACCGCTCGCAGAATTGTA
AAACGGGCGACCGTGGTTT -> AACGGGCGACCGTGGTTTG
AAACTCCATTCTGAGCGAC -> AACTCCATTCTGAGCGACG
AAACTCTGTTGTGCAGGAT -> AACTCTGTTGTGCAGGATA
AAACTCTTAGGGGTACATT -> AACTCTTAGGGGTACATTC
AAACTCTTAGTGTAGTATT -> AACTCTTAGTGTAGTATTA
AAAGACCCGCACCTAAACC -> AAGACCCGCACCTAAACCG
AAAGAGAAGAACCTTCTTC -> AAGAGAAGAACCTTCTTCA
AAAGAGCCCACACCGGCTG -> AAGAGCCCACACCGGCTGC
AAAGATCGCGATATGGTGT -> AAGATCGCGATATGGTGTG
AAAGCCTTTAGAGGTACGC -> AAGCCTTTAGAGGTACGCG
AAAGCGAATGATGGTCTGC -> AAGCGAATGATGGTCTGCG
AAATACGGTGTTCTACACG -> AATACGGTGTTCTACACGA
AAATCAATACAGCAACAAA -> AATCAATACAGCAACAAAG
AAATCAATACAGCAACCTG -> AATCAATACAGCAACCTGG
AAATCAATACAGCAACGTG -> AATCAATACAGCAACGTGA
AAATCAATACAGCAACTCT -> AATCAATACAGCAACTCTA
AAATCACACCTCTCAACAA -> AATCACACCTCTCAACAAG
AAATCGGGAAATACGGTGT -> AATCGGGAAATACGGTGTT
AAATTAGAACTATAATCTA -> AATTAGAACTATAATCTAT
AAATTTGACACTTTCGGCC -> AATTTGACACTTTCGGCCG
AACAAACAAGACAGTTGGC -> ACAAACAAGACAGTTGGCC
AACAAAGACCCGCACCTAA -> ACAAAGACCCGCACCTAAA
AACAAGACAGTTGGCCGGC -> ACAAGACAGTTGGCCGGCT
AACAAGTGAGGAATGCGAA -> ACAAGTGAGGAATGCGAAC
AACAGCCGAAGGAATTCCG -> ACAGCCGAAGGAATTCCGT
AACAGCTGGCCAGTGGACG -> ACAGCTGGCCAGTGGACGT
AACAGGCCCATACCGGGAC -> ACAGGCCCATACCGGGACA
AACCAAGGCATGAGGCGTA -> ACCAAGGCATGAGGCGTAA
AACCCTAAACCGCTCGCAG -> ACCCTAAACCGCTCGCAGA
AACCGATGAAGGGTGGCGT -> ACCGATGAAGGGTGGCGTT
AACCGCAGAGTTCGAGCGC -> ACCGCAGAGTTCGAGCGCT
AACCGCTCGCAGAATAAGC -> ACCGCTCGCAGAATAAGCC
AACCGCTCGCAGAATCAGG -> ACCGCTCGCAGAATCAGGG
AACCGCTCGCAGAATTATC -> ACCGCTCGCAGAATTATCT
AACCGCTCGCAGAATTGTA -> ACCGCTCGCAGAATTGTAC
AACCGTATAACCTTAAGAC -> ACCGTATAACCTTAAGACG
AACCGTGAGCCCGCCTACG -> ACCGTGAGCCCGCCTACGC
AACCGTTCGGCTAGTGGTA -> ACCGTTCGGCTAGTGGTAG
AACCTGGGCGAAACCCTAA -> ACCTGGGCGAAACCCTAAA
AACCTTAAGACGGTTTTGT -> ACCTTAAGACGGTTTTGTT
AACCTTCCAGGACACCAGA -> ACCTTCCAGGACACCAGAT
AACCTTCTTCAAGAGTAAA -> ACCTTCTTCAAGAGTAAAG
AACGAGTTACCCATATTAG -> ACGAGTTACCCATATTAGA
AACGCCATTGACGACCTTT -> ACGCCATTGACGACCTTTT
AACGCCTAAACTCCATTCT -> ACGCCTAAACTCCATTCTG
AACGGACCCAAAGAGAAGA -> ACGGACCCAAAGAGAAGAA
AACGGACCGCTGGTTGATA -> ACGGACCGCTGGTTGATAC
AACGGGCGACCGTGGTTTG -> ACGGGCGACCGTGGTTTGG
AACGTGATGTAGTCCCTAA -> ACGTGATGTAGTCCCTAAA
AACTATAATCTATGTGTCA -> ACTATAATCTATGTGTCAC
AACTCCATTCTGAGCGACG -> ACTCCATTCTGAGCGACGC
AACTCTACAGAGTCCCTAA -> ACTCTACAGAGTCCCTAAA
AACTCTGTTGTGCAGGATA -> ACTCTGTTGTGCAGGATAA
AACTCTTAGGGGTACATTC -> ACTCTTAGGGGTACATTCG
AACTCTTAGTGTAGTATTA -> ACTCTTAGTGTAGTATTAC
AACTCTTCGGGACCTATTT -> ACTCTTCGGGACCTATTTA
AACTTCAGCGAAACAGCCG -> ACTTCAGCGAAACAGCCGA
AAGAAATCAATACAGCAAC -> AGAAATCAATACAGCAACA
AAGAACCTTCTTCAAGAGT -> AGAACCTTCTTCAAGAGTA
AAGAAGCGAAGTTTAGACT -> AGAAGCGAAGTTTAGACTC
AAGACAGTTGGCCGGCTTG -> AGACAGTTGGCCGGCTTGG
AAGACCCGCACCTAAACCG -> AGACCCGCACCTAAACCGC
AAGACGGTTTTGTTAAGAC -> AGACGGTTTTGTTAAGACT
AAGACTAACGAGTTACCCA -> AGACTAACGAGTTACCCAT
AAGAGAAGAACCTTCTTCA -> AGAGAAGAACCTTCTTCAA
AAGAGCCCACACCGGCTGC -> AGAGCCCACACCGGCTGCC
AAGAGTAAAGATCGCGATA -> AGAGTAAAGATCGCGATAT
AAGAGTCAGCTACTTGGGC -> AGAGTCAGCTACTTGGGCT
AAGATCGCGATATGGTGTG -> AGATCGCGATATGGTGTGT
AAGATTTCAATAGTGATCG -> AGATTTCAATAGTGATCGT
AAGCCAGAACCGTTCGGCT -> AGCCAGAACCGTTCGGCTA
AAGCCTGCGACCGTAATTT -> AGCCTGCGACCGTAATTTG
AAGCCTTTAGAGGTACGCG -> AGCCTTTAGAGGTACGCGA
AAGCGAAGTTTAGACTCTC -> AGCGAAGTTTAGACTCTCA
AAGCGAATGATGGTCTGCG -> AGCGAATGATGGTCTGCGT
AAGCGTGATCTAGATAGTT -> AGCGTGATCTAGATAGTTT
AAGCTTAACAGCTGGCCAG -> AGCTTAACAGCTGGCCAGT
AAGCTTCCTGTGGTTAGAC -> AGCTTCCTGTGGTTAGACG
AAGCTTTTACCCTAGGAAT -> AGCTTTTACCCTAGGAATT
AAGGAATTCCGTCCTTTCC -> AGGAATTCCGTCCTTTCCA
AAGGAGTGGAACCGTATAA -> AGGAGTGGAACCGTATAAC
AAGGCATGAGGCGTAATGG -> AGGCATGAGGCGTAATGGA
AAGGGTGGCGTTCAGGAGT -> AGGGTGGCGTTCAGGAGTC
AAGGTCACGCTATGCGCTC -> AGGTCACGCTATGCGCTCG
AAGGTTAGGTGTACTGCGT -> AGGTTAGGTGTACTGCGTA
AAGTAAGTCGCTGACCGAT -> AGTAAGTCGCTGACCGATG
AAGTACCGGGCTCAAATTA -> AGTACCGGGCTCAAATTAG
AAGTAGGAAGAAATCAATA -> AGTAGGAAGAAATCAATAC
AAGTCGCTGACCGATGTTC -> AGTCGCTGACCGATGTTCA
AAGTCTCACCCGCCGGTTA -> AGTCTCACCCGCCGGTTAG
AAGTGAGGAATGCGAACAA -> AGTGAGGAATGCGAACAAA
AAGTGCATCATCTGTACGC -> AGTGCATCATCTGTACGCT
AAGTTAACCTTCCAGGACA -> AGTTAACCTTCCAGGACAC
AAGTTGGGATGCGTGTCCC -> AGTTGGGATGCGTGTCCCA
AAGTTGTCTCGGAGAAATC -> AGTTGTCTCGGAGAAATCA
AAGTTTAGACTCTCATTGA -> AGTTTAGACTCTCATTGAA
AATAACGCCTAAACTCCAT -> ATAACGCCTAAACTCCATT
AATAAGCCTGCGACCGTAA -> ATAAGCCTGCGACCGTAAT
AATAATCCTCGGTAATATT -> ATAATCCTCGGTAATATTA
AATACAGCAACAAAGACCC -> ATACAGCAACAAAGACCCG
AATACAGCAACCTGGGCGA -> ATACAGCAACCTGGGCGAA
AATACAGCAACGTGATGTA -> ATACAGCAACGTGATGTAG
AATACAGCAACTCTACAGA -> ATACAGCAACTCTACAGAG
AATACGGTGTTCTACACGA -> ATACGGTGTTCTACACGAA
AATAGCGGCGCCTCGTTCA -> ATAGCGGCGCCTCGTTCAA
AATAGGGCTTGCGCACTGG -> ATAGGGCTTGCGCACTGGC
AATAGTAAGAGTCAGCTAC -> ATAGTAAGAGTCAGCTACT
AATAGTGATCGTAACCAAG -> ATAGTGATCGTAACCAAGG
AATATTAAGTACCGGGCTC -> ATATTAAGTACCGGGCTCA
AATCAATACAGCAACAAAG -> ATCAATACAGCAACAAAGA
AATCAATACAGCAACCTGG -> ATCAATACAGCAACCTGGG
AATCAATACAGCAACGTGA -> ATCAATACAGCAACGTGAT
AATCAATACAGCAACTCTA -> ATCAATACAGCAACTCTAC
AATCACACCTCTCAACAAG -> ATCACACCTCTCAACAAGT
AATCAGGGATAGGGCAGTA -> ATCAGGGATAGGGCAGTAT
AATCCGGTACGCGGGCATC -> ATCCGGTACGCGGGCATCA
AATCCTCGGTAATATTAAG -> ATCCTCGGTAATATTAAGT
AATCGGCGAGAATGGGAAT -> ATCGGCGAGAATGGGAATC
AATCGGGAAATACGGTGTT -> ATCGGGAAATACGGTGTTC
AATCTATGTGTCACACAGG -> ATCTATGTGTCACACAGGG
AATCTCCATTTCTGGTAAT -> ATCTCCATTTCTGGTAATG
AATGAGGATGAGCCATATA -> ATGAGGATGAGCCATATAT
AATGATGGTCTGCGTAGGT -> ATGATGGTCTGCGTAGGTC
AATGCGAACAAACAAGACA -> ATGCGAACAAACAAGACAG
AATGCGTATTTAATCTCCA -> ATGCGTATTTAATCTCCAT
AATGCTTGACCGGTGCGGC -> ATGCTTGACCGGTGCGGCT
AATGGAAGCCAGAACCGTT -> ATGGAAGCCAGAACCGTTC
AATGGGAATCCGGTACGCG -> ATGGGAATCCGGTACGCGG
AATGGGCGCGGTGAGAGGA -> ATGGGCGCGGTGAGAGGAT
AATTACAAATGTGTTATGT -> ATTACAAATGTGTTATGTA
AATTAGAAAAACTCTTAGT -> ATTAGAAAAACTCTTAGTG
AATTAGAACTATAATCTAT -> ATTAGAACTATAATCTATG
AATTAGTGTCTACGTTAGG -> ATTAGTGTCTACGTTAGGC
AATTATCTGGGCTTAGAGG -> ATTATCTGGGCTTAGAGGC
AATTCCGTCCTTTCCAACG -> ATTCCGTCCTTTCCAACGC
AATTGTACTAAGCGTGATC -> ATTGTACTAAGCGTGATCT
AATTTGACACTTTCGGCCG -> ATTTGACACTTTCGGCCGC
AATTTGCGCACACATACTT -> ATTTGCGCACACATACTTG
ACAAACAAGACAGTTGGCC -> CAAACAAGACAGTTGGCCG
ACAAACGGGCGACCGTGGT -> CAAACGGGCGACCGTGGTT
ACAAAGACCCGCACCTAAA -> CAAAGACCCGCACCTAAAC
ACAAGACAGTTGGCCGGCT -> CAAGACAGTTGGCCGGCTT
ACAAGATTTCAATAGTGAT -> CAAGATTTCAATAGTGATC
ACAAGTGAGGAATGCGAAC -> CAAGTGAGGAATGCGAACA
ACACAGGGTGTCGCCAGTA -> CACAGGGTGTCGCCAGTAT
ACACATACTTGCACTAGCG -> CACATACTTGCACTAGCGT
ACACCAGATGCGAGTAGAT -> CACCAGATGCGAGTAGATG
ACACCGGCTGCCATAAGCT -> CACCGGCTGCCATAAGCTT
ACACCTCTCAACAAGTGAG -> CACCTCTCAACAAGTGAGG
ACACCTGTCGGGAGTTTGT -> CACCTGTCGGGAGTTTGTG
ACACGAAGTAAGTCGCTGA -> CACGAAGTAAGTCGCTGAC
ACACTTTCGGCCGCGGTCT -> CACTTTCGGCCGCGGTCTC
ACAGAGTCCCTAAACCGCT -> CAGAGTCCCTAAACCGCTC
ACAGCAACAAAGACCCGCA -> CAGCAACAAAGACCCGCAC
ACAGCAACCTGGGCGAAAC -> CAGCAACCTGGGCGAAACC
ACAGCAACGTGATGTAGTC -> CAGCAACGTGATGTAGTCC
ACAGCAACTCTACAGAGTC -> CAGCAACTCTACAGAGTCC
ACAGCCGAAGGAATTCCGT -> CAGCCGAAGGAATTCCGTC
ACAGCTGGCCAGTGGACGT -> CAGCTGGCCAGTGGACGTT
ACAGGCCCATACCGGGACA -> CAGGCCCATACCGGGACAA
ACAGGGTGTCGCCAGTATT -> CAGGGTGTCGCCAGTATTA
ACAGTGTATATAACGGACC -> CAGTGTATATAACGGACCG
ACAGTTATCATCGTTATCT -> CAGTTATCATCGTTATCTC
ACAGTTGGCCGGCTTGGCC -> CAGTTGGCCGGCTTGGCCG
ACATACTTGCACTAGCGTC -> CATACTTGCACTAGCGTCT
ACATCGCGTTCCATAATGC -> CATCGCGTTCCATAATGCG
ACATTAAGTTAACCTTCCA -> CATTAAGTTAACCTTCCAG
ACATTCGGTTTATGAGAGG -> CATTCGGTTTATGAGAGGG
ACCAAGGCATGAGGCGTAA -> CCAAGGCATGAGGCGTAAT
ACCAGATGCGAGTAGATGA -> CCAGATGCGAGTAGATGAT
ACCATACCCAGGGTACCTT -> CCATACCCAGGGTACCTTT
ACCCAAAGAGAAGAACCTT -> CCCAAAGAGAAGAACCTTC
ACCCAGGGTACCTTTCGCG -> CCCAGGGTACCTTTCGCGG
ACCCATATTAGAAGTGCAT -> CCCATATTAGAAGTGCATC
ACCCCCACTTCGGGTCGCT -> CCCCCACTTCGGGTCGCTC
ACCCCCCGCGATTTGACTA -> CCCCCCGCGATTTGACTAA
ACCCCCGCGCGATATAAGC -> CCCCCGCGCGATATAAGCT
ACCCCGTTGTGCGCCAACT -> CCCCGTTGTGCGCCAACTC
ACCCGCACCTAAACCGCTC -> CCCGCACCTAAACCGCTCG
ACCCGCCGGTTAGACATCG -> CCCGCCGGTTAGACATCGC
ACCCTAAACCGCTCGCAGA -> CCCTAAACCGCTCGCAGAA
ACCCTAGGAATTAGTGTCT -> CCCTAGGAATTAGTGTCTA
ACCCTTAATAGTAAGAGTC -> CCCTTAATAGTAAGAGTCA
ACCGATGAAGGGTGGCGTT -> CCGATGAAGGGTGGCGTTC
ACCGATGTTCAGAAATCAA -> CCGATGTTCAGAAATCAAT
ACCGCAGAGTTCGAGCGCT -> CCGCAGAGTTCGAGCGCTC
ACCGCGACCCTTAATAGTA -> CCGCGACCCTTAATAGTAA
ACCGCTCGCAGAATAAGCC -> CCGCTCGCAGAATAAGCCT
ACCGCTCGCAGAATCAGGG -> CCGCTCGCAGAATCAGGGA
ACCGCTCGCAGAATTATCT -> CCGCTCGCAGAATTATCTG
ACCGCTCGCAGAATTGTAC -> CCGCTCGCAGAATTGTACT
ACCGCTGGTTGATACCCCG -> CCGCTGGTTGATACCCCGT
ACCGGCTGCCATAAGCTTT -> CCGGCTGCCATAAGCTTTT
ACCGGGACAAACGGGCGAC -> CCGGGACAAACGGGCGACC
ACCGGGCTCAAATTAGAAC -> CCGGGCTCAAATTAGAACT
ACCGGTGCGGCTAGCTGGC -> CCGGTGCGGCTAGCTGGCA
ACCGTAAACTCTGTTGTGC -> CCGTAAACTCTGTTGTGCA
ACCGTAATTTGCGCACACA -> CCGTAATTTGCGCACACAT
ACCGTATAACCTTAAGACG -> CCGTATAACCTTAAGACGG
ACCGTGAGCCCGCCTACGC -> CCGTGAGCCCGCCTACGCC
ACCGTGGTTTGGCACATTA -> CCGTGGTTTGGCACATTAA
ACCGTTCGGCTAGTGGTAG -> CCGTTCGGCTAGTGGTAGC
ACCTAAACCGCTCGCAGAA -> CCTAAACCGCTCGCAGAAT
ACCTATTTACTAAGGTCAC -> CCTATTTACTAAGGTCACG
ACCTCTCAACAAGTGAGGA -> CCTCTCAACAAGTGAGGAA
ACCTGCACGTGTCATTTAA -> CCTGCACGTGTCATTTAAG
ACCTGGGCGAAACCCTAAA -> CCTGGGCGAAACCCTAAAC
ACCTGGTGAGAAAACTCTT -> CCTGGTGAGAAAACTCTTA
ACCTGTCGGGAGTTTGTGC -> CCTGTCGGGAGTTTGTGCA
ACCTTAAGACGGTTTTGTT -> CCTTAAGACGGTTTTGTTA
ACCTTCCAGGACACCAGAT -> CCTTCCAGGACACCAGATG
ACCTTCTTCAAGAGTAAAG -> CCTTCTTCAAGAGTAAAGA
ACCTTTCGCGGTGACCGCG -> CCTTTCGCGGTGACCGCGA
ACCTTTTGAAGGTTAGGTG -> CCTTTTGAAGGTTAGGTGT
ACGAAGTAAGTCGCTGACC -> CGAAGTAAGTCGCTGACCG
ACGACCTTTTGAAGGTTAG -> CGACCTTTTGAAGGTTAGG
ACGAGTTACCCATATTAGA -> CGAGTTACCCATATTAGAA
ACGATATTGTTAGAAATCA -> CGATATTGTTAGAAATCAA
ACGCATCCCGTATCCGGGG -> CGCATCCCGTATCCGGGGC
ACGCATTGTAATGCTTGAC -> CGCATTGTAATGCTTGACC
ACGCCATTGACGACCTTTT -> CGCCATTGACGACCTTTTG
ACGCCCATGTTCCTAAGTC -> CGCCCATGTTCCTAAGTCT
ACGCCTAAACTCCATTCTG -> CGCCTAAACTCCATTCTGA
ACGCGAGGCGTGACAGTGT -> CGCGAGGCGTGACAGTGTA
ACGCGGGCATCAATAATCC -> CGCGGGCATCAATAATCCT
ACGCTATGCGCTCGGGCTG -> CGCTATGCGCTCGGGCTGG
ACGCTGAGTCAAAGCGAAT -> CGCTGAGTCAAAGCGAATG
ACGGACCCAAAGAGAAGAA -> CGGACCCAAAGAGAAGAAC
ACGGACCGCTGGTTGATAC -> CGGACCGCTGGTTGATACC
ACGGGCGACCGTGGTTTGG -> CGGGCGACCGTGGTTTGGC
ACGGTGTTCTACACGAAGT -> CGGTGTTCTACACGAAGTA
ACGGTTTTGTTAAGACTAA -> CGGTTTTGTTAAGACTAAC
ACGTAAATCACACCTCTCA -> CGTAAATCACACCTCTCAA
ACGTCTGCGGATCCCCCAC -> CGTCTGCGGATCCCCCACA
ACGTGATGTAGTCCCTAAA -> CGTGATGTAGTCCCTAAAC
ACGTGGGGAGGCGTTTCAG -> CGTGGGGAGGCGTTTCAGG
ACGTGTCATTTAAGTAGGA -> CGTGTCATTTAAGTAGGAA
ACGTTAGGCATTTACCCCC -> CGTTAGGCATTTACCCCCC
ACGTTTCTGGGGTAGCGCT -> CGTTTCTGGGGTAGCGCTT
ACTAACGAGTTACCCATAT -> CTAACGAGTTACCCATATT
ACTAAGCGTGATCTAGATA -> CTAAGCGTGATCTAGATAG
ACTAAGGTCACGCTATGCG -> CTAAGGTCACGCTATGCGC
ACTAATGAGGATGAGCCAT -> CTAATGAGGATGAGCCATA
ACTAGCCCCGGGTAACCGT -> CTAGCCCCGGGTAACCGTG
ACTAGCGTCTCCTTACGAT -> CTAGCGTCTCCTTACGATA
ACTATAATCTATGTGTCAC -> CTATAATCTATGTGTCACA
ACTATTGGTCCGCCGAGTC -> CTATTGGTCCGCCGAGTCG
ACTCCATTCTGAGCGACGC -> CTCCATTCTGAGCGACGCA
ACTCTACAGAGTCCCTAAA -> CTCTACAGAGTCCCTAAAC
ACTCTCATTGAAGTTGGGA -> CTCTCATTGAAGTTGGGAT
ACTCTGTTGTGCAGGATAA -> CTCTGTTGTGCAGGATAAG
ACTCTTAGGGGTACATTCG -> CTCTTAGGGGTACATTCGG
ACTCTTAGTGTAGTATTAC -> CTCTTAGTGTAGTATTACC
ACTCTTCGGGACCTATTTA -> CTCTTCGGGACCTATTTAC
ACTGCGTACGTGGGGAGGC -> CTGCGTACGTGGGGAGGCG
ACTGGCTCATTTTGAGTGG -> CTGGCTCATTTTGAGTGGA
ACTTCAGCGAAACAGCCGA -> CTTCAGCGAAACAGCCGAA
ACTTCGGGTCGCTCGATGC -> CTTCGGGTCGCTCGATGCT
ACTTGCACTAGCGTCTCCT -> CTTGCACTAGCGTCTCCTT
ACTTGGGCTTTTAACAGGC -> CTTGGGCTTTTAACAGGCC
ACTTTCGGCCGCGGTCTCA -> CTTTCGGCCGCGGTCTCAG
ACTTTGTAGGATATTTTAG -> CTTTGTAGGATATTTTAGG
AGAAAAACTCTTAGTGTAG -> GAAAAACTCTTAGTGTAGT
AGAAAACTCTTAGGGGTAC -> GAAAACTCTTAGGGGTACA
AGAAATCAATACAGCAACA -> GAAATCAATACAGCAACAA
AGAAATCAATACAGCAACC -> GAAATCAATACAGCAACCT
AGAAATCAATACAGCAACG -> GAAATCAATACAGCAACGT
AGAAATCAATACAGCAACT -> GAAATCAATACAGCAACTC
AGAACCGTTCGGCTAGTGG -> GAACCGTTCGGCTAGTGGT
AGAACCTTCTTCAAGAGTA -> GAACCTTCTTCAAGAGTAA
AGAACTATAATCTATGTGT -> GAACTATAATCTATGTGTC
AGAACTTCAGCGAAACAGC -> GAACTTCAGCGAAACAGCC
AGAAGAACCTTCTTCAAGA -> GAAGAACCTTCTTCAAGAG
AGAAGCGAAGTTTAGACTC -> GAAGCGAAGTTTAGACTCT
AGAAGTGCATCATCTGTAC -> GAAGTGCATCATCTGTACG
AGAATAAGCCTGCGACCGT -> GAATAAGCCTGCGACCGTA
AGAATCAGGGATAGGGCAG -> GAATCAGGGATAGGGCAGT
AGAATGGGAATCCGGTACG -> GAATGGGAATCCGGTACGC
AGAATTATCTGGGCTTAGA -> GAATTATCTGGGCTTAGAG
AGAATTGTACTAAGCGTGA -> GAATTGTACTAAGCGTGAT
AGACAGTTGGCCGGCTTGG -> GACAGTTGGCCGGCTTGGC
AGACATCGCGTTCCATAAT -> GACATCGCGTTCCATAATG
AGACCCCCACTTCGGGTCG -> GACCCCCACTTCGGGTCGC
AGACCCGCACCTAAACCGC -> GACCCGCACCTAAACCGCT
AGACGCATCCCGTATCCGG -> GACGCATCCCGTATCCGGG
AGACGGTTTTGTTAAGACT -> GACGGTTTTGTTAAGACTA
AGACGTCTGCGGATCCCCC -> GACGTCTGCGGATCCCCCA
AGACTAACGAGTTACCCAT -> GACTAACGAGTTACCCATA
AGACTCTCATTGAAGTTGG -> GACTCTCATTGAAGTTGGG
AGAGAACTTCAGCGAAACA -> GAGAACTTCAGCGAAACAG
AGAGAAGAACCTTCTTCAA -> GAGAAGAACCTTCTTCAAG
AGAGAGAACTTCAGCGAAA -> GAGAGAACTTCAGCGAAAC
AGAGCCCACACCGGCTGCC -> GAGCCCACACCGGCTGCCA
AGAGGACTATTGGTCCGCC -> GAGGACTATTGGTCCGCCG
AGAGGATCCGGACTTTGTA -> GAGGATCCGGACTTTGTAG
AGAGGCTTTCATGATTGCA -> GAGGCTTTCATGATTGCAG
AGAGGGTCTGAGGAAGTTG -> GAGGGTCTGAGGAAGTTGT
AGAGGTACGCGAGGCGTGA -> GAGGTACGCGAGGCGTGAC
AGAGTAAAGATCGCGATAT -> GAGTAAAGATCGCGATATG
AGAGTCAGCTACTTGGGCT -> GAGTCAGCTACTTGGGCTT
AGAGTCCCTAAACCGCTCG -> GAGTCCCTAAACCGCTCGC
AGAGTTCGAGCGCTCAATA -> GAGTTCGAGCGCTCAATAG
AGATAGTTTTAAGGAGTGG -> GATAGTTTTAAGGAGTGGA
AGATCGCGATATGGTGTGT -> GATCGCGATATGGTGTGTA
AGATGATTCGGATTGTGGA -> GATGATTCGGATTGTGGAT
AGATGCGAGTAGATGATTC -> GATGCGAGTAGATGATTCG
AGATTTCAATAGTGATCGT -> GATTTCAATAGTGATCGTA
AGCAACAAAGACCCGCACC -> GCAACAAAGACCCGCACCT
AGCAACCTGGGCGAAACCC -> GCAACCTGGGCGAAACCCT
AGCAACGTGATGTAGTCCC -> GCAACGTGATGTAGTCCCT
AGCAACTCTACAGAGTCCC -> GCAACTCTACAGAGTCCCT
AGCAGGGCGAGGTCATAAT -> GCAGGGCGAGGTCATAATA
AGCCAGAACCGTTCGGCTA -> GCCAGAACCGTTCGGCTAG
AGCCATATATTCAACCGAT -> GCCATATATTCAACCGATG
AGCCCACACCGGCTGCCAT -> GCCCACACCGGCTGCCATA
AGCCCCGGGTAACCGTGAG -> GCCCCGGGTAACCGTGAGC
AGCCCCGGTTGGCGCGATC -> GCCCCGGTTGGCGCGATCA
AGCCCGCCTACGCCCATGT -> GCCCGCCTACGCCCATGTT
AGCCGAAGGAATTCCGTCC -> GCCGAAGGAATTCCGTCCT
AGCCTGCGACCGTAATTTG -> GCCTGCGACCGTAATTTGC
AGCCTGGGTATCTGTTTCA -> GCCTGGGTATCTGTTTCAG
AGCCTTTAGAGGTACGCGA -> GCCTTTAGAGGTACGCGAG
AGCGAAACAGCCGAAGGAA -> GCGAAACAGCCGAAGGAAT
AGCGAAGTTTAGACTCTCA -> GCGAAGTTTAGACTCTCAT
AGCGAATGATGGTCTGCGT -> GCGAATGATGGTCTGCGTA
AGCGACGCATTGTAATGCT -> GCGACGCATTGTAATGCTT
AGCGCTCAATAGCGGCGCC -> GCGCTCAATAGCGGCGCCT
AGCGCTTACCGTAAACTCT -> GCGCTTACCGTAAACTCTG
AGCGGCGCCTCGTTCAAAT -> GCGGCGCCTCGTTCAAATC
AGCGTCTCCTTACGATATT -> GCGTCTCCTTACGATATTG
AGCGTGATCTAGATAGTTT -> GCGTGATCTAGATAGTTTT
AGCGTGCTAAAGCCTTTAG -> GCGTGCTAAAGCCTTTAGA
AGCTACTTGGGCTTTTAAC -> GCTACTTGGGCTTTTAACA
AGCTGGCAACGGACCCAAA -> GCTGGCAACGGACCCAAAG
AGCTGGCCAGTGGACGTTT -> GCTGGCCAGTGGACGTTTC
AGCTTAACAGCTGGCCAGT -> GCTTAACAGCTGGCCAGTG
AGCTTCCTGTGGTTAGACG -> GCTTCCTGTGGTTAGACGC
AGCTTTTACCCTAGGAATT -> GCTTTTACCCTAGGAATTA
AGGAAGAAATCAATACAGC -> GGAAGAAATCAATACAGCA
AGGAAGTTGTCTCGGAGAA -> GGAAGTTGTCTCGGAGAAA
AGGAATGCGAACAAACAAG -> GGAATGCGAACAAACAAGA
AGGAATTAGTGTCTACGTT -> GGAATTAGTGTCTACGTTA
AGGAATTCCGTCCTTTCCA -> GGAATTCCGTCCTTTCCAA
AGGACACCAGATGCGAGTA -> GGACACCAGATGCGAGTAG
AGGACCCCCGCGCGATATA -> GGACCCCCGCGCGATATAA
AGGACTATTGGTCCGCCGA -> GGACTATTGGTCCGCCGAG
AGGAGTCTTGAGCGTGCTA -> GGAGTCTTGAGCGTGCTAA
AGGAGTGGAACCGTATAAC -> GGAGTGGAACCGTATAACC
AGGATAAGCTTCCTGTGGT -> GGATAAGCTTCCTGTGGTT
AGGATATTTTAGGACCCCC -> GGATATTTTAGGACCCCCG
AGGATCCGGACTTTGTAGG -> GGATCCGGACTTTGTAGGA
AGGATGAGCCATATATTCA -> GGATGAGCCATATATTCAA
AGGCAATTACAAATGTGTT -> GGCAATTACAAATGTGTTA
AGGCATGAGGCGTAATGGA -> GGCATGAGGCGTAATGGAA
AGGCATTTACCCCCCGCGA -> GGCATTTACCCCCCGCGAT
AGGCCCATACCGGGACAAA -> GGCCCATACCGGGACAAAC
AGGCGTAATGGAAGCCAGA -> GGCGTAATGGAAGCCAGAA
AGGCGTGACAGTGTATATA -> GGCGTGACAGTGTATATAA
AGGCGTTTCAGGCAATTAC -> GGCGTTTCAGGCAATTACA
AGGCTTTCATGATTGCAGA -> GGCTTTCATGATTGCAGAG
AGGGAATAACGCCTAAACT -> GGGAATAACGCCTAAACTC
AGGGATAGGGCAGTATCCC -> GGGATAGGGCAGTATCCCC
AGGGCAGTATCCCCGGCTA -> GGGCAGTATCCCCGGCTAA
AGGGCGAGGTCATAATAGG -> GGGCGAGGTCATAATAGGG
AGGGCTTGCGCACTGGCTC -> GGGCTTGCGCACTGGCTCA
AGGGGTACATTCGGTTTAT -> GGGGTACATTCGGTTTATG
AGGGTACCTTTCGCGGTGA -> GGGTACCTTTCGCGGTGAC
AGGGTACGTAAATCACACC -> GGGTACGTAAATCACACCT
AGGGTCTGAGGAAGTTGTC -> GGGTCTGAGGAAGTTGTCT
AGGGTGGCGTTCAGGAGTC -> GGGTGGCGTTCAGGAGTCT
AGGGTGTCGCCAGTATTAG -> GGGTGTCGCCAGTATTAGT
AGGTACGCGAGGCGTGACA -> GGTACGCGAGGCGTGACAG
AGGTCACCATACCCAGGGT -> GGTCACCATACCCAGGGTA
AGGTCACGCTATGCGCTCG -> GGTCACGCTATGCGCTCGG
AGGTCATAATAGGGCTTGC -> GGTCATAATAGGGCTTGCG
AGGTCCAGCCCCGGTTGGC -> GGTCCAGCCCCGGTTGGCG
AGGTCGCGACACCTGTCGG -> GGTCGCGACACCTGTCGGG
AGGTGTACTGCGTACGTGG -> GGTGTACTGCGTACGTGGG
AGGTTAGGTGTACTGCGTA -> GGTTAGGTGTACTGCGTAC
AGTAAAGATCGCGATATGG -> GTAAAGATCGCGATATGGT
AGTAAGAGTCAGCTACTTG -> GTAAGAGTCAGCTACTTGG
AGTAAGTCGCTGACCGATG -> GTAAGTCGCTGACCGATGT
AGTACCGGGCTCAAATTAG -> GTACCGGGCTCAAATTAGA
AGTAGATGATTCGGATTGT -> GTAGATGATTCGGATTGTG
AGTAGGAAGAAATCAATAC -> GTAGGAAGAAATCAATACA
AGTATCCCCGGCTAATTAG -> GTATCCCCGGCTAATTAGA
AGTATTACCTGGTGAGAAA -> GTATTACCTGGTGAGAAAA
AGTATTAGTGTCAGGTCAC -> GTATTAGTGTCAGGTCACC
AGTCAAAGCGAATGATGGT -> GTCAAAGCGAATGATGGTC
AGTCAGCTACTTGGGCTTT -> GTCAGCTACTTGGGCTTTT
AGTCCCTAAACCGCTCGCA -> GTCCCTAAACCGCTCGCAG,GTCCCTAAACCGCTCGCAG
AGTCGCTGACCGATGTTCA -> GTCGCTGACCGATGTTCAG
AGTCGCTTTTCGCAGGGAA -> GTCGCTTTTCGCAGGGAAT
AGTCTCACCCGCCGGTTAG -> GTCTCACCCGCCGGTTAGA
AGTCTTGAGCGTGCTAAAG -> GTCTTGAGCGTGCTAAAGC
AGTGAGGAATGCGAACAAA -> GTGAGGAATGCGAACAAAC
AGTGATCGTAACCAAGGCA -> GTGATCGTAACCAAGGCAT
AGTGCATCATCTGTACGCT -> GTGCATCATCTGTACGCTG
AGTGGAAACCGCAGAGTTC -> GTGGAAACCGCAGAGTTCG
AGTGGAACCGTATAACCTT -> GTGGAACCGTATAACCTTA
AGTGGACGTTTCTGGGGTA -> GTGGACGTTTCTGGGGTAG
AGTGGTAGCCTGGGTATCT -> GTGGTAGCCTGGGTATCTG
AGTGTAGTATTACCTGGTG -> GTGTAGTATTACCTGGTGA
AGTGTATATAACGGACCGC -> GTGTATATAACGGACCGCT
AGTGTCAGGTCACCATACC -> GTGTCAGGTCACCATACCC
AGTGTCTACGTTAGGCATT -> GTGTCTACGTTAGGCATTT
AGTTAACCTTCCAGGACAC -> GTTAACCTTCCAGGACACC
AGTTACCCATATTAGAAGT -> GTTACCCATATTAGAAGTG
AGTTATCATCGTTATCTCC -> GTTATCATCGTTATCTCCA
AGTTCGAGCGCTCAATAGC -> GTTCGAGCGCTCAATAGCG
AGTTGGCCGGCTTGGCCGC -> GTTGGCCGGCTTGGCCGCC
AGTTGGGATGCGTGTCCCA -> GTTGGGATGCGTGTCCCAG
AGTTGTCTCGGAGAAATCA -> GTTGTCTCGGAGAAATCAA
AGTTTAGACTCTCATTGAA -> GTTTAGACTCTCATTGAAG
AGTTTGTGCACCTGCACGT -> GTTTGTGCACCTGCACGTG
AGTTTTAAGGAGTGGAACC -> GTTTTAAGGAGTGGAACCG
ATAACCTTAAGACGGTTTT -> TAACCTTAAGACGGTTTTG
ATAACGCCTAAACTCCATT -> TAACGCCTAAACTCCATTC
ATAACGGACCGCTGGTTGA -> TAACGGACCGCTGGTTGAT
ATAAGCCTGCGACCGTAAT -> TAAGCCTGCGACCGTAATT
ATAAGCTTAACAGCTGGCC -> TAAGCTTAACAGCTGGCCA
ATAAGCTTCCTGTGGTTAG -> TAAGCTTCCTGTGGTTAGA
ATAAGCTTTTACCCTAGGA -> TAAGCTTTTACCCTAGGAA
ATAATAGGGCTTGCGCACT -> TAATAGGGCTTGCGCACTG
ATAATCCTCGGTAATATTA -> TAATCCTCGGTAATATTAA
ATAATCTATGTGTCACACA -> TAATCTATGTGTCACACAG
ATAATGCGTATTTAATCTC -> TAATGCGTATTTAATCTCC
ATACAGCAACAAAGACCCG -> TACAGCAACAAAGACCCGC
ATACAGCAACCTGGGCGAA -> TACAGCAACCTGGGCGAAA
ATACAGCAACGTGATGTAG -> TACAGCAACGTGATGTAGT
ATACAGCAACTCTACAGAG -> TACAGCAACTCTACAGAGT
ATACCCAGGGTACCTTTCG -> TACCCAGGGTACCTTTCGC
ATACCCCGTTGTGCGCCAA -> TACCCCGTTGTGCGCCAAC
ATACCGGGACAAACGGGCG -> TACCGGGACAAACGGGCGA
ATACGGTGTTCTACACGAA -> TACGGTGTTCTACACGAAG
ATACTTGCACTAGCGTCTC -> TACTTGCACTAGCGTCTCC
ATAGACGTCTGCGGATCCC -> TAGACGTCTGCGGATCCCC
ATAGCGGCGCCTCGTTCAA -> TAGCGGCGCCTCGTTCAAA
ATAGGGCAGTATCCCCGGC -> TAGGGCAGTATCCCCGGCT
ATAGGGCTTGCGCACTGGC -> TAGGGCTTGCGCACTGGCT
ATAGTAAGAGTCAGCTACT -> TAGTAAGAGTCAGCTACTT
ATAGTGATCGTAACCAAGG -> TAGTGATCGTAACCAAGGC
ATAGTTTTAAGGAGTGGAA -> TAGTTTTAAGGAGTGGAAC
ATATAACGGACCGCTGGTT -> TATAACGGACCGCTGGTTG
ATATAAGCTTAACAGCTGG -> TATAAGCTTAACAGCTGGC
ATATATTCAACCGATGAAG -> TATATTCAACCGATGAAGG
ATATGGTGTGTAAATTTGA -> TATGGTGTGTAAATTTGAC
ATATTAAGTACCGGGCTCA -> TATTAAGTACCGGGCTCAA
ATATTAGAAGTGCATCATC -> TATTAGAAGTGCATCATCT
ATATTCAACCGATGAAGGG -> TATTCAACCGATGAAGGGT
ATATTGTTAGAAATCAATA -> TATTGTTAGAAATCAATAC
ATATTTTAGGACCCCCGCG -> TATTTTAGGACCCCCGCGC
ATCAATAATCCTCGGTAAT -> TCAATAATCCTCGGTAATA
ATCAATACAGCAACAAAGA -> TCAATACAGCAACAAAGAC
ATCAATACAGCAACCTGGG -> TCAATACAGCAACCTGGGC
ATCAATACAGCAACGTGAT -> TCAATACAGCAACGTGATG
ATCAATACAGCAACTCTAC -> TCAATACAGCAACTCTACA
ATCACACCTCTCAACAAGT -> TCACACCTCTCAACAAGTG
ATCAGGGATAGGGCAGTAT -> TCAGGGATAGGGCAGTATC
ATCATCGTTATCTCCAATC -> TCATCGTTATCTCCAATCG
ATCATCTGTACGCTGAGTC -> TCATCTGTACGCTGAGTCA
ATCATTTACTAGCCCCGGG -> TCATTTACTAGCCCCGGGT
ATCCCCCACAAGATTTCAA -> TCCCCCACAAGATTTCAAT
ATCCCCGGCTAATTAGAAA -> TCCCCGGCTAATTAGAAAA
ATCCCGTATCCGGGGCCAT -> TCCCGTATCCGGGGCCATT
ATCCGGACTTTGTAGGATA -> TCCGGACTTTGTAGGATAT
ATCCGGGGCCATTCGGGTG -> TCCGGGGCCATTCGGGTGC
ATCCGGTACGCGGGCATCA -> TCCGGTACGCGGGCATCAA
ATCCTCGGTAATATTAAGT -> TCCTCGGTAATATTAAGTA
ATCGAGAGAGAACTTCAGC -> TCGAGAGAGAACTTCAGCG
ATCGCGATATGGTGTGTAA -> TCGCGATATGGTGTGTAAA
ATCGCGTTCCATAATGCGT -> TCGCGTTCCATAATGCGTA
ATCGGCGAGAATGGGAATC -> TCGGCGAGAATGGGAATCC
ATCGGGAAATACGGTGTTC -> TCGGGAAATACGGTGTTCT
ATCGTAACCAAGGCATGAG -> TCGTAACCAAGGCATGAGG
ATCGTTATCTCCAATCGGC -> TCGTTATCTCCAATCGGCG
ATCTAGATAGTTTTAAGGA -> TCTAGATAGTTTTAAGGAG
ATCTATGTGTCACACAGGG -> TCTATGTGTCACACAGGGT
ATCTCCAATCGGCGAGAAT -> TCTCCAATCGGCGAGAATG
ATCTCCATTTCTGGTAATG -> TCTCCATTTCTGGTAATGG
ATCTCTATGTGAGGTCGCG -> TCTCTATGTGAGGTCGCGA
ATCTGGGCTTAGAGGCTTT -> TCTGGGCTTAGAGGCTTTC
ATCTGTACGCTGAGTCAAA -> TCTGTACGCTGAGTCAAAG
ATCTGTTTCAGACCCCCAC -> TCTGTTTCAGACCCCCACT
ATGAAGGGTGGCGTTCAGG -> TGAAGGGTGGCGTTCAGGA
ATGAGAGGGTCTGAGGAAG -> TGAGAGGGTCTGAGGAAGT
ATGAGCCATATATTCAACC -> TGAGCCATATATTCAACCG
ATGAGGATGAGCCATATAT -> TGAGGATGAGCCATATATT
ATGAGGCGTAATGGAAGCC -> TGAGGCGTAATGGAAGCCA
ATGATGGTCTGCGTAGGTC -> TGATGGTCTGCGTAGGTCC
ATGATTCGGATTGTGGATC -> TGATTCGGATTGTGGATCG
ATGATTGCAGAGGACTATT -> TGATTGCAGAGGACTATTG
ATGCGAACAAACAAGACAG -> TGCGAACAAACAAGACAGT
ATGCGAGTAGATGATTCGG -> TGCGAGTAGATGATTCGGA
ATGCGCTCGGGCTGGCGCA -> TGCGCTCGGGCTGGCGCAC
ATGCGTATTTAATCTCCAT -> TGCGTATTTAATCTCCATT
ATGCGTGTCCCAGCAGGGC -> TGCGTGTCCCAGCAGGGCG
ATGCTCGTAAGAAGCGAAG -> TGCTCGTAAGAAGCGAAGT
ATGCTTGACCGGTGCGGCT -> TGCTTGACCGGTGCGGCTA
ATGGAAGCCAGAACCGTTC -> TGGAAGCCAGAACCGTTCG
ATGGGAATCCGGTACGCGG -> TGGGAATCCGGTACGCGGG
ATGGGCGCGGTGAGAGGAT -> TGGGCGCGGTGAGAGGATC
ATGGTCTGCGTAGGTCCAG -> TGGTCTGCGTAGGTCCAGC
ATGGTGTGTAAATTTGACA -> TGGTGTGTAAATTTGACAC
ATGTAGTCCCTAAACCGCT -> TGTAGTCCCTAAACCGCTC
ATGTGAGGTCGCGACACCT -> TGTGAGGTCGCGACACCTG
ATGTGTCACACAGGGTGTC -> TGTGTCACACAGGGTGTCG
ATGTTCAGAAATCAATACA -> TGTTCAGAAATCAATACAG
ATGTTCCTAAGTCTCACCC -> TGTTCCTAAGTCTCACCCG
ATTAAGTACCGGGCTCAAA -> TTAAGTACCGGGCTCAAAT
ATTAAGTTAACCTTCCAGG -> TTAAGTTAACCTTCCAGGA
ATTACCTGGTGAGAAAACT -> TTACCTGGTGAGAAAACTC
ATTAGAAAAACTCTTAGTG -> TTAGAAAAACTCTTAGTGT
ATTAGAACTATAATCTATG -> TTAGAACTATAATCTATGT
ATTAGAAGTGCATCATCTG -> TTAGAAGTGCATCATCTGT
ATTAGTGTCAGGTCACCAT -> TTAGTGTCAGGTCACCATA
ATTAGTGTCTACGTTAGGC -> TTAGTGTCTACGTTAGGCA
ATTATCTGGGCTTAGAGGC -> TTATCTGGGCTTAGAGGCT
ATTCAACCGATGAAGGGTG -> TTCAACCGATGAAGGGTGG
ATTCCGTCCTTTCCAACGC -> TTCCGTCCTTTCCAACGCC
ATTCGGATTGTGGATCGAG -> TTCGGATTGTGGATCGAGA
ATTCGGGTGCAAAGAGCCC -> TTCGGGTGCAAAGAGCCCA
ATTCGGTTTATGAGAGGGT -> TTCGGTTTATGAGAGGGTC
ATTCGTATCTCTATGTGAG -> TTCGTATCTCTATGTGAGG
ATTCTGAGCGACGCATTGT -> TTCTGAGCGACGCATTGTA
ATTGAAGTTGGGATGCGTG -> TTGAAGTTGGGATGCGTGT
ATTGACGACCTTTTGAAGG -> TTGACGACCTTTTGAAGGT
ATTGCAGAGGACTATTGGT -> TTGCAGAGGACTATTGGTC
ATTGGTCCGCCGAGTCGCT -> TTGGTCCGCCGAGTCGCTT
ATTGTAATGCTTGACCGGT -> TTGTAATGCTTGACCGGTG
ATTGTACTAAGCGTGATCT -> TTGTACTAAGCGTGATCTA
ATTGTGGATCGAGAGAGAA -> TTGTGGATCGAGAGAGAAC
ATTGTTAGAAATCAATACA -> TTGTTAGAAATCAATACAG
ATTTAAGTAGGAAGAAATC -> TTTAAGTAGGAAGAAATCA
ATTTAATCTCCATTTCTGG -> TTTAATCTCCATTTCTGGT
ATTTACCCCCCGCGATTTG -> TTTACCCCCCGCGATTTGA
ATTTACTAAGGTCACGCTA -> TTTACTAAGGTCACGCTAT
ATTTACTAGCCCCGGGTAA -> TTTACTAGCCCCGGGTAAC
ATTTCAATAGTGATCGTAA -> TTTCAATAGTGATCGTAAC
ATTTCTGGTAATGGGCGCG -> TTTCTGGTAATGGGCGCGG
ATTTGACACTTTCGGCCGC -> TTTGACACTTTCGGCCGCG
ATTTGACTAATGAGGATGA -> TTTGACTAATGAGGATGAG
ATTTGCGCACACATACTTG -> TTTGCGCACACATACTTGC
ATTTTAGGACCCCCGCGCG -> TTTTAGGACCCCCGCGCGA
ATTTTGAGTGGAAACCGCA -> TTTTGAGTGGAAACCGCAG
CAAACAAGACAGTTGGCCG -> AAACAAGACAGTTGGCCGG
CAAACGGGCGACCGTGGTT -> AAACGGGCGACCGTGGTTT
CAAAGACCCGCACCTAAAC -> AAAGACCCGCACCTAAACC
CAAAGAGAAGAACCTTCTT -> AAAGAGAAGAACCTTCTTC
CAAAGAGCCCACACCGGCT -> AAAGAGCCCACACCGGCTG
CAAAGCGAATGATGGTCTG -> AAAGCGAATGATGGTCTGC
CAAATCGGGAAATACGGTG -> AAATCGGGAAATACGGTGT
CAAATTAGAACTATAATCT -> AAATTAGAACTATAATCTA
CAACAAAGACCCGCACCTA -> AACAAAGACCCGCACCTAA
CAACAAGTGAGGAATGCGA -> AACAAGTGAGGAATGCGAA
CAACCGATGAAGGGTGGCG -> AACCGATGAAGGGTGGCGT
CAACCTGGGCGAAACCCTA -> AACCTGGGCGAAACCCTAA
CAACGCCATTGACGACCTT -> AACGCCATTGACGACCTTT
CAACGGACCCAAAGAGAAG -> AACGGACCCAAAGAGAAGA
CAACGTGATGTAGTCCCTA -> AACGTGATGTAGTCCCTAA
CAACTCTACAGAGTCCCTA -> AACTCTACAGAGTCCCTAA
CAACTCTTCGGGACCTATT -> AACTCTTCGGGACCTATTT
CAAGACAGTTGGCCGGCTT -> AAGACAGTTGGCCGGCTTG
CAAGAGTAAAGATCGCGAT -> AAGAGTAAAGATCGCGATA
CAAGATTTCAATAGTGATC -> AAGATTTCAATAGTGATCG
CAAGGCATGAGGCGTAATG -> AAGGCATGAGGCGTAATGG
CAAGTGAGGAATGCGAACA -> AAGTGAGGAATGCGAACAA
CAATAATCCTCGGTAATAT -> AATAATCCTCGGTAATATT
CAATACAGCAACAAAGACC -> AATACAGCAACAAAGACCC
CAATACAGCAACCTGGGCG -> AATACAGCAACCTGGGCGA
CAATACAGCAACGTGATGT -> AATACAGCAACGTGATGTA
CAATACAGCAACTCTACAG -> AATACAGCAACTCTACAGA
CAATAGCGGCGCCTCGTTC -> AATAGCGGCGCCTCGTTCA
CAATAGTGATCGTAACCAA -> AATAGTGATCGTAACCAAG
CAATCGGCGAGAATGGGAA -> AATCGGCGAGAATGGGAAT
CAATTACAAATGTGTTATG -> AATTACAAATGTGTTATGT
CACAAGATTTCAATAGTGA -> ACAAGATTTCAATAGTGAT
CACACAGGGTGTCGCCAGT -> ACACAGGGTGTCGCCAGTA
CACACATACTTGCACTAGC -> ACACATACTTGCACTAGCG
CACACCGGCTGCCATAAGC -> ACACCGGCTGCCATAAGCT
CACACCTCTCAACAAGTGA -> ACACCTCTCAACAAGTGAG
CACAGGGTGTCGCCAGTAT -> ACAGGGTGTCGCCAGTATT
CACAGTTATCATCGTTATC -> ACAGTTATCATCGTTATCT
CACATACTTGCACTAGCGT -> ACATACTTGCACTAGCGTC
CACATTAAGTTAACCTTCC -> ACATTAAGTTAACCTTCCA
CACCAGATGCGAGTAGATG -> ACCAGATGCGAGTAGATGA
CACCATACCCAGGGTACCT -> ACCATACCCAGGGTACCTT
CACCCGCCGGTTAGACATC -> ACCCGCCGGTTAGACATCG
CACCGGCTGCCATAAGCTT -> ACCGGCTGCCATAAGCTTT
CACCTAAACCGCTCGCAGA -> ACCTAAACCGCTCGCAGAA
CACCTCTCAACAAGTGAGG -> ACCTCTCAACAAGTGAGGA
CACCTGCACGTGTCATTTA -> ACCTGCACGTGTCATTTAA
CACCTGTCGGGAGTTTGTG -> ACCTGTCGGGAGTTTGTGC
CACGAAGTAAGTCGCTGAC -> ACGAAGTAAGTCGCTGACC
CACGCTATGCGCTCGGGCT -> ACGCTATGCGCTCGGGCTG
CACGTGTCATTTAAGTAGG -> ACGTGTCATTTAAGTAGGA
CACTAGCGTCTCCTTACGA -> ACTAGCGTCTCCTTACGAT
CACTGGCTCATTTTGAGTG -> ACTGGCTCATTTTGAGTGG
CACTTCGGGTCGCTCGATG -> ACTTCGGGTCGCTCGATGC
CACTTTCGGCCGCGGTCTC -> ACTTTCGGCCGCGGTCTCA
CAGAAATCAATACAGCAAC -> AGAAATCAATACAGCAACC
CAGAACCGTTCGGCTAGTG -> AGAACCGTTCGGCTAGTGG
CAGAATAAGCCTGCGACCG -> AGAATAAGCCTGCGACCGT
CAGAATCAGGGATAGGGCA -> AGAATCAGGGATAGGGCAG
CAGAATTATCTGGGCTTAG -> AGAATTATCTGGGCTTAGA
CAGAATTGTACTAAGCGTG -> AGAATTGTACTAAGCGTGA
CAGACCCCCACTTCGGGTC -> AGACCCCCACTTCGGGTCG
CAGAGGACTATTGGTCCGC -> AGAGGACTATTGGTCCGCC
CAGAGTCCCTAAACCGCTC -> AGAGTCCCTAAACCGCTCG
CAGAGTTCGAGCGCTCAAT -> AGAGTTCGAGCGCTCAATA
CAGATGCGAGTAGATGATT -> AGATGCGAGTAGATGATTC
CAGCAACAAAGACCCGCAC -> AGCAACAAAGACCCGCACC
CAGCAACCTGGGCGAAACC -> AGCAACCTGGGCGAAACCC
CAGCAACGTGATGTAGTCC -> AGCAACGTGATGTAGTCCC
CAGCAACTCTACAGAGTCC -> AGCAACTCTACAGAGTCCC
CAGCAGGGCGAGGTCATAA -> AGCAGGGCGAGGTCATAAT
CAGCCCCGGTTGGCGCGAT -> AGCCCCGGTTGGCGCGATC
CAGCCGAAGGAATTCCGTC -> AGCCGAAGGAATTCCGTCC
CAGCGAAACAGCCGAAGGA -> AGCGAAACAGCCGAAGGAA
CAGCTACTTGGGCTTTTAA -> AGCTACTTGGGCTTTTAAC
CAGCTGGCCAGTGGACGTT -> AGCTGGCCAGTGGACGTTT
CAGGACACCAGATGCGAGT -> AGGACACCAGATGCGAGTA
CAGGAGTCTTGAGCGTGCT -> AGGAGTCTTGAGCGTGCTA
CAGGATAAGCTTCCTGTGG -> AGGATAAGCTTCCTGTGGT
CAGGCAATTACAAATGTGT -> AGGCAATTACAAATGTGTT
CAGGCCCATACCGGGACAA -> AGGCCCATACCGGGACAAA
CAGGGAATAACGCCTAAAC -> AGGGAATAACGCCTAAACT
CAGGGATAGGGCAGTATCC -> AGGGATAGGGCAGTATCCC
CAGGGCGAGGTCATAATAG -> AGGGCGAGGTCATAATAGG
CAGGGTACCTTTCGCGGTG -> AGGGTACCTTTCGCGGTGA
CAGGGTACGTAAATCACAC -> AGGGTACGTAAATCACACC
CAGGGTGTCGCCAGTATTA -> AGGGTGTCGCCAGTATTAG
CAGGTCACCATACCCAGGG -> AGGTCACCATACCCAGGGT
CAGTATCCCCGGCTAATTA -> AGTATCCCCGGCTAATTAG
CAGTATTAGTGTCAGGTCA -> AGTATTAGTGTCAGGTCAC
CAGTGGACGTTTCTGGGGT -> AGTGGACGTTTCTGGGGTA
CAGTGTATATAACGGACCG -> AGTGTATATAACGGACCGC
CAGTTATCATCGTTATCTC -> AGTTATCATCGTTATCTCC
CAGTTGGCCGGCTTGGCCG -> AGTTGGCCGGCTTGGCCGC
CATAAGCTTTTACCCTAGG -> ATAAGCTTTTACCCTAGGA
CATAATAGGGCTTGCGCAC -> ATAATAGGGCTTGCGCACT
CATAATGCGTATTTAATCT -> ATAATGCGTATTTAATCTC
CATACCCAGGGTACCTTTC -> ATACCCAGGGTACCTTTCG
CATACCGGGACAAACGGGC -> ATACCGGGACAAACGGGCG
CATACTTGCACTAGCGTCT -> ATACTTGCACTAGCGTCTC
CATAGACGTCTGCGGATCC -> ATAGACGTCTGCGGATCCC
CATATATTCAACCGATGAA -> ATATATTCAACCGATGAAG
CATATTAGAAGTGCATCAT -> ATATTAGAAGTGCATCATC
CATCAATAATCCTCGGTAA -> ATCAATAATCCTCGGTAAT
CATCATCTGTACGCTGAGT -> ATCATCTGTACGCTGAGTC
CATCCCGTATCCGGGGCCA -> ATCCCGTATCCGGGGCCAT
CATCGCGTTCCATAATGCG -> ATCGCGTTCCATAATGCGT
CATCGTTATCTCCAATCGG -> ATCGTTATCTCCAATCGGC
CATCTGTACGCTGAGTCAA -> ATCTGTACGCTGAGTCAAA
CATGAGGCGTAATGGAAGC -> ATGAGGCGTAATGGAAGCC
CATGATTGCAGAGGACTAT -> ATGATTGCAGAGGACTATT
CATGTTCCTAAGTCTCACC -> ATGTTCCTAAGTCTCACCC
CATTAAGTTAACCTTCCAG -> ATTAAGTTAACCTTCCAGG
CATTCGGGTGCAAAGAGCC -> ATTCGGGTGCAAAGAGCCC
CATTCGGTTTATGAGAGGG -> ATTCGGTTTATGAGAGGGT
CATTCTGAGCGACGCATTG -> ATTCTGAGCGACGCATTGT
CATTGAAGTTGGGATGCGT -> ATTGAAGTTGGGATGCGTG
CATTGACGACCTTTTGAAG -> ATTGACGACCTTTTGAAGG
CATTGTAATGCTTGACCGG -> ATTGTAATGCTTGACCGGT
CATTTAAGTAGGAAGAAAT -> ATTTAAGTAGGAAGAAATC
CATTTACCCCCCGCGATTT -> ATTTACCCCCCGCGATTTG
CATTTACTAGCCCCGGGTA -> ATTTACTAGCCCCGGGTAA
CATTTCTGGTAATGGGCGC -> ATTTCTGGTAATGGGCGCG
CATTTTGAGTGGAAACCGC -> ATTTTGAGTGGAAACCGCA
CCAAAGAGAAGAACCTTCT -> CAAAGAGAAGAACCTTCTT
CCAACGCCATTGACGACCT -> CAACGCCATTGACGACCTT
CCAACTCTTCGGGACCTAT -> CAACTCTTCGGGACCTATT
CCAAGGCATGAGGCGTAAT -> CAAGGCATGAGGCGTAATG
CCAATCGGCGAGAATGGGA -> CAATCGGCGAGAATGGGAA
CCACAAGATTTCAATAGTG -> CACAAGATTTCAATAGTGA
CCACACCGGCTGCCATAAG -> CACACCGGCTGCCATAAGC
CCACTTCGGGTCGCTCGAT -> CACTTCGGGTCGCTCGATG
CCAGAACCGTTCGGCTAGT -> CAGAACCGTTCGGCTAGTG
CCAGATGCGAGTAGATGAT -> CAGATGCGAGTAGATGATT
CCAGCAGGGCGAGGTCATA -> CAGCAGGGCGAGGTCATAA
CCAGCCCCGGTTGGCGCGA -> CAGCCCCGGTTGGCGCGAT
CCAGGACACCAGATGCGAG -> CAGGACACCAGATGCGAGT
CCAGGGTACCTTTCGCGGT -> CAGGGTACCTTTCGCGGTG
CCAGTATTAGTGTCAGGTC -> CAGTATTAGTGTCAGGTCA
CCAGTGGACGTTTCTGGGG -> CAGTGGACGTTTCTGGGGT
CCATAAGCTTTTACCCTAG -> CATAAGCTTTTACCCTAGG
CCATAATGCGTATTTAATC -> CATAATGCGTATTTAATCT
CCATACCCAGGGTACCTTT -> CATACCCAGGGTACCTTTC
CCATACCGGGACAAACGGG -> CATACCGGGACAAACGGGC
CCATAGACGTCTGCGGATC -> CATAGACGTCTGCGGATCC
CCATATATTCAACCGATGA -> CATATATTCAACCGATGAA
CCATATTAGAAGTGCATCA -> CATATTAGAAGTGCATCAT
CCATGTTCCTAAGTCTCAC -> CATGTTCCTAAGTCTCACC
CCATTCGGGTGCAAAGAGC -> CATTCGGGTGCAAAGAGCC
CCATTCTGAGCGACGCATT -> CATTCTGAGCGACGCATTG
CCATTGACGACCTTTTGAA -> CATTGACGACCTTTTGAAG
CCATTTCTGGTAATGGGCG -> CATTTCTGGTAATGGGCGC
CCCAAAGAGAAGAACCTTC -> CCAAAGAGAAGAACCTTCT
CCCACAAGATTTCAATAGT -> CCACAAGATTTCAATAGTG
CCCACACCGGCTGCCATAA -> CCACACCGGCTGCCATAAG
CCCACTTCGGGTCGCTCGA -> CCACTTCGGGTCGCTCGAT
CCCAGCAGGGCGAGGTCAT -> CCAGCAGGGCGAGGTCATA
CCCAGGGTACCTTTCGCGG -> CCAGGGTACCTTTCGCGGT
CCCATACCGGGACAAACGG -> CCATACCGGGACAAACGGG
CCCATAGACGTCTGCGGAT -> CCATAGACGTCTGCGGATC
CCCATATTAGAAGTGCATC -> CCATATTAGAAGTGCATCA
CCCATGTTCCTAAGTCTCA -> CCATGTTCCTAAGTCTCAC
CCCCACAAGATTTCAATAG -> CCCACAAGATTTCAATAGT
CCCCACTTCGGGTCGCTCG -> CCCACTTCGGGTCGCTCGA
CCCCCACAAGATTTCAATA -> CCCCACAAGATTTCAATAG
CCCCCACTTCGGGTCGCTC -> CCCCACTTCGGGTCGCTCG
CCCCCCGCGATTTGACTAA -> CCCCCGCGATTTGACTAAT
CCCCCGCGATTTGACTAAT -> CCCCGCGATTTGACTAATG
CCCCCGCGCGATATAAGCT -> CCCCGCGCGATATAAGCTT
CCCCGCGATTTGACTAATG -> CCCGCGATTTGACTAATGA
CCCCGCGCGATATAAGCTT -> CCCGCGCGATATAAGCTTA
CCCCGGCTAATTAGAAAAA -> CCCGGCTAATTAGAAAAAC
CCCCGGGTAACCGTGAGCC -> CCCGGGTAACCGTGAGCCC
CCCCGGTTGGCGCGATCAT -> CCCGGTTGGCGCGATCATT
CCCCGTTGTGCGCCAACTC -> CCCGTTGTGCGCCAACTCT
CCCGCACCTAAACCGCTCG -> CCGCACCTAAACCGCTCGC
CCCGCCGGTTAGACATCGC -> CCGCCGGTTAGACATCGCG
CCCGCCTACGCCCATGTTC -> CCGCCTACGCCCATGTTCC
CCCGCGATTTGACTAATGA -> CCGCGATTTGACTAATGAG
CCCGCGCGATATAAGCTTA -> CCGCGCGATATAAGCTTAA
CCCGGCTAATTAGAAAAAC -> CCGGCTAATTAGAAAAACT
CCCGGGTAACCGTGAGCCC -> CCGGGTAACCGTGAGCCCG
CCCGGTTGGCGCGATCATT -> CCGGTTGGCGCGATCATTT
CCCGTATCCGGGGCCATTC -> CCGTATCCGGGGCCATTCG
CCCGTTGTGCGCCAACTCT -> CCGTTGTGCGCCAACTCTT
CCCTAAACCGCTCGCAGAA -> CCTAAACCGCTCGCAGAAT,CCTAAACCGCTCGCAGAAT,CCTAAACCGCTCGCAGAAT
CCCTAGGAATTAGTGTCTA -> CCTAGGAATTAGTGTCTAC
CCCTTAATAGTAAGAGTCA -> CCTTAATAGTAAGAGTCAG
CCGAAGGAATTCCGTCCTT -> CGAAGGAATTCCGTCCTTT
CCGAGTCGCTTTTCGCAGG -> CGAGTCGCTTTTCGCAGGG
CCGATGAAGGGTGGCGTTC -> CGATGAAGGGTGGCGTTCA
CCGATGTTCAGAAATCAAT -> CGATGTTCAGAAATCAATA
CCGCACCTAAACCGCTCGC -> CGCACCTAAACCGCTCGCA
CCGCAGAGTTCGAGCGCTC -> CGCAGAGTTCGAGCGCTCA
CCGCCGAGTCGCTTTTCGC -> CGCCGAGTCGCTTTTCGCA
CCGCCGGTTAGACATCGCG -> CGCCGGTTAGACATCGCGT
CCGCCTACGCCCATGTTCC -> CGCCTACGCCCATGTTCCT
CCGCCTCCCATAGACGTCT -> CGCCTCCCATAGACGTCTG
CCGCGACCCTTAATAGTAA -> CGCGACCCTTAATAGTAAG
CCGCGATTTGACTAATGAG -> CGCGATTTGACTAATGAGG
CCGCGCGATATAAGCTTAA -> CGCGCGATATAAGCTTAAC
CCGCGGTCTCAGGGTACGT -> CGCGGTCTCAGGGTACGTA
CCGCTCGCAGAATAAGCCT -> CGCTCGCAGAATAAGCCTG
CCGCTCGCAGAATCAGGGA -> CGCTCGCAGAATCAGGGAT
CCGCTCGCAGAATTATCTG -> CGCTCGCAGAATTATCTGG
CCGCTCGCAGAATTGTACT -> CGCTCGCAGAATTGTACTA
CCGCTGGTTGATACCCCGT -> CGCTGGTTGATACCCCGTT
CCGGACTTTGTAGGATATT -> CGGACTTTGTAGGATATTT
CCGGCTAATTAGAAAAACT -> CGGCTAATTAGAAAAACTC
CCGGCTGCCATAAGCTTTT -> CGGCTGCCATAAGCTTTTA
CCGGCTTGGCCGCCTCCCA -> CGGCTTGGCCGCCTCCCAT
CCGGGACAAACGGGCGACC -> CGGGACAAACGGGCGACCG
CCGGGCTCAAATTAGAACT -> CGGGCTCAAATTAGAACTA
CCGGGGCCATTCGGGTGCA -> CGGGGCCATTCGGGTGCAA
CCGGGTAACCGTGAGCCCG -> CGGGTAACCGTGAGCCCGC
CCGGTACGCGGGCATCAAT -> CGGTACGCGGGCATCAATA
CCGGTGCGGCTAGCTGGCA -> CGGTGCGGCTAGCTGGCAA
CCGGTTAGACATCGCGTTC -> CGGTTAGACATCGCGTTCC
CCGGTTGGCGCGATCATTT -> CGGTTGGCGCGATCATTTA
CCGTAAACTCTGTTGTGCA -> CGTAAACTCTGTTGTGCAG
CCGTAATTTGCGCACACAT -> CGTAATTTGCGCACACATA
CCGTATAACCTTAAGACGG -> CGTATAACCTTAAGACGGT
CCGTATCCGGGGCCATTCG -> CGTATCCGGGGCCATTCGG
CCGTCCTTTCCAACGCCAT -> CGTCCTTTCCAACGCCATT
CCGTGAGCCCGCCTACGCC -> CGTGAGCCCGCCTACGCCC
CCGTGGTTTGGCACATTAA -> CGTGGTTTGGCACATTAAG
CCGTTCGGCTAGTGGTAGC -> CGTTCGGCTAGTGGTAGCC
CCGTTGTGCGCCAACTCTT -> CGTTGTGCGCCAACTCTTC
CCTAAACCGCTCGCAGAAT -> CTAAACCGCTCGCAGAATA,CTAAACCGCTCGCAGAATT,CTAAACCGCTCGCAGAATC,CTAAACCGCTCGCAGAATT
CCTAAACTCCATTCTGAGC -> CTAAACTCCATTCTGAGCG
CCTAAGTCTCACCCGCCGG -> CTAAGTCTCACCCGCCGGT
CCTACGCCCATGTTCCTAA -> CTACGCCCATGTTCCTAAG
CCTAGGAATTAGTGTCTAC -> CTAGGAATTAGTGTCTACG
CCTATTTACTAAGGTCACG -> CTATTTACTAAGGTCACGC
CCTCCCATAGACGTCTGCG -> CTCCCATAGACGTCTGCGG
CCTCGGTAATATTAAGTAC -> CTCGGTAATATTAAGTACC
CCTCGTTCAAATCGGGAAA -> CTCGTTCAAATCGGGAAAT
CCTCTCAACAAGTGAGGAA -> CTCTCAACAAGTGAGGAAT
CCTGCACGTGTCATTTAAG -> CTGCACGTGTCATTTAAGT
CCTGCGACCGTAATTTGCG -> CTGCGACCGTAATTTGCGC
CCTGGGCGAAACCCTAAAC -> CTGGGCGAAACCCTAAACC
CCTGGGTATCTGTTTCAGA -> CTGGGTATCTGTTTCAGAC
CCTGGTGAGAAAACTCTTA -> CTGGTGAGAAAACTCTTAG
CCTGTCGGGAGTTTGTGCA -> CTGTCGGGAGTTTGTGCAC
CCTGTGGTTAGACGCATCC -> CTGTGGTTAGACGCATCCC
CCTTAAGACGGTTTTGTTA -> CTTAAGACGGTTTTGTTAA
CCTTAATAGTAAGAGTCAG -> CTTAATAGTAAGAGTCAGC
CCTTACGATATTGTTAGAA -> CTTACGATATTGTTAGAAA
CCTTCCAGGACACCAGATG -> CTTCCAGGACACCAGATGC
CCTTCTTCAAGAGTAAAGA -> CTTCTTCAAGAGTAAAGAT
CCTTTAGAGGTACGCGAGG -> CTTTAGAGGTACGCGAGGC
CCTTTCCAACGCCATTGAC -> CTTTCCAACGCCATTGACG
CCTTTCGCGGTGACCGCGA -> CTTTCGCGGTGACCGCGAC
CCTTTTGAAGGTTAGGTGT -> CTTTTGAAGGTTAGGTGTA
CGAAACAGCCGAAGGAATT -> GAAACAGCCGAAGGAATTC
CGAAACCCTAAACCGCTCG -> GAAACCCTAAACCGCTCGC
CGAACAAACAAGACAGTTG -> GAACAAACAAGACAGTTGG
CGAAGGAATTCCGTCCTTT -> GAAGGAATTCCGTCCTTTC
CGAAGTAAGTCGCTGACCG -> GAAGTAAGTCGCTGACCGA
CGAAGTTTAGACTCTCATT -> GAAGTTTAGACTCTCATTG
CGAATGATGGTCTGCGTAG -> GAATGATGGTCTGCGTAGG
CGACACCTGTCGGGAGTTT -> GACACCTGTCGGGAGTTTG
CGACCCTTAATAGTAAGAG -> GACCCTTAATAGTAAGAGT
CGACCGTAATTTGCGCACA -> GACCGTAATTTGCGCACAC
CGACCGTGGTTTGGCACAT -> GACCGTGGTTTGGCACATT
CGACCTTTTGAAGGTTAGG -> GACCTTTTGAAGGTTAGGT
CGACGCATTGTAATGCTTG -> GACGCATTGTAATGCTTGA
CGAGAATGGGAATCCGGTA -> GAGAATGGGAATCCGGTAC
CGAGAGAGAACTTCAGCGA -> GAGAGAGAACTTCAGCGAA
CGAGCGCTCAATAGCGGCG -> GAGCGCTCAATAGCGGCGC
CGAGGCGTGACAGTGTATA -> GAGGCGTGACAGTGTATAT
CGAGGTCATAATAGGGCTT -> GAGGTCATAATAGGGCTTG
CGAGTAGATGATTCGGATT -> GAGTAGATGATTCGGATTG
CGAGTCGCTTTTCGCAGGG -> GAGTCGCTTTTCGCAGGGA
CGAGTTACCCATATTAGAA -> GAGTTACCCATATTAGAAG
CGATATAAGCTTAACAGCT -> GATATAAGCTTAACAGCTG
CGATATGGTGTGTAAATTT -> GATATGGTGTGTAAATTTG
CGATATTGTTAGAAATCAA -> GATATTGTTAGAAATCAAT
CGATCATTTACTAGCCCCG -> GATCATTTACTAGCCCCGG
CGATGAAGGGTGGCGTTCA -> GATGAAGGGTGGCGTTCAG
CGATGCTCGTAAGAAGCGA -> GATGCTCGTAAGAAGCGAA
CGATGTTCAGAAATCAATA -> GATGTTCAGAAATCAATAC
CGATTTGACTAATGAGGAT -> GATTTGACTAATGAGGATG
CGCACACATACTTGCACTA -> GCACACATACTTGCACTAG
CGCACAGTTATCATCGTTA -> GCACAGTTATCATCGTTAT
CGCACCTAAACCGCTCGCA -> GCACCTAAACCGCTCGCAG
CGCACTGGCTCATTTTGAG -> GCACTGGCTCATTTTGAGT
CGCAGAATAAGCCTGCGAC -> GCAGAATAAGCCTGCGACC
CGCAGAATCAGGGATAGGG -> GCAGAATCAGGGATAGGGC
CGCAGAATTATCTGGGCTT -> GCAGAATTATCTGGGCTTA
CGCAGAATTGTACTAAGCG -> GCAGAATTGTACTAAGCGT
CGCAGAGTTCGAGCGCTCA -> GCAGAGTTCGAGCGCTCAA
CGCAGGGAATAACGCCTAA -> GCAGGGAATAACGCCTAAA
CGCATCCCGTATCCGGGGC -> GCATCCCGTATCCGGGGCC
CGCATTGTAATGCTTGACC -> GCATTGTAATGCTTGACCG
CGCCAACTCTTCGGGACCT -> GCCAACTCTTCGGGACCTA
CGCCAGTATTAGTGTCAGG -> GCCAGTATTAGTGTCAGGT
CGCCATTGACGACCTTTTG -> GCCATTGACGACCTTTTGA
CGCCCATGTTCCTAAGTCT -> GCCCATGTTCCTAAGTCTC
CGCCGAGTCGCTTTTCGCA -> GCCGAGTCGCTTTTCGCAG
CGCCGGTTAGACATCGCGT -> GCCGGTTAGACATCGCGTT
CGCCTAAACTCCATTCTGA -> GCCTAAACTCCATTCTGAG
CGCCTACGCCCATGTTCCT -> GCCTACGCCCATGTTCCTA
CGCCTCCCATAGACGTCTG -> GCCTCCCATAGACGTCTGC
CGCCTCGTTCAAATCGGGA -> GCCTCGTTCAAATCGGGAA
CGCGACACCTGTCGGGAGT -> GCGACACCTGTCGGGAGTT
CGCGACCCTTAATAGTAAG -> GCGACCCTTAATAGTAAGA
CGCGAGGCGTGACAGTGTA -> GCGAGGCGTGACAGTGTAT
CGCGATATAAGCTTAACAG -> GCGATATAAGCTTAACAGC
CGCGATATGGTGTGTAAAT -> GCGATATGGTGTGTAAATT
CGCGATCATTTACTAGCCC -> GCGATCATTTACTAGCCCC
CGCGATTTGACTAATGAGG -> GCGATTTGACTAATGAGGA
CGCGCGATATAAGCTTAAC -> GCGCGATATAAGCTTAACA
CGCGGGCATCAATAATCCT -> GCGGGCATCAATAATCCTC
CGCGGTCTCAGGGTACGTA -> GCGGTCTCAGGGTACGTAA
CGCGGTGACCGCGACCCTT -> GCGGTGACCGCGACCCTTA
CGCGGTGAGAGGATCCGGA -> GCGGTGAGAGGATCCGGAC
CGCGTTCCATAATGCGTAT -> GCGTTCCATAATGCGTATT
CGCTATGCGCTCGGGCTGG -> GCTATGCGCTCGGGCTGGC
CGCTCAATAGCGGCGCCTC -> GCTCAATAGCGGCGCCTCG
CGCTCGATGCTCGTAAGAA -> GCTCGATGCTCGTAAGAAG
CGCTCGCAGAATAAGCCTG -> GCTCGCAGAATAAGCCTGC
CGCTCGCAGAATCAGGGAT -> GCTCGCAGAATCAGGGATA
CGCTCGCAGAATTATCTGG -> GCTCGCAGAATTATCTGGG
CGCTCGCAGAATTGTACTA -> GCTCGCAGAATTGTACTAA
CGCTCGGGCTGGCGCACAG -> GCTCGGGCTGGCGCACAGT
CGCTGACCGATGTTCAGAA -> GCTGACCGATGTTCAGAAA
CGCTGAGTCAAAGCGAATG -> GCTGAGTCAAAGCGAATGA
CGCTGGTTGATACCCCGTT -> GCTGGTTGATACCCCGTTG
CGCTTACCGTAAACTCTGT -> GCTTACCGTAAACTCTGTT
CGCTTTTCGCAGGGAATAA -> GCTTTTCGCAGGGAATAAC
CGGACCCAAAGAGAAGAAC -> GGACCCAAAGAGAAGAACC
CGGACCGCTGGTTGATACC -> GGACCGCTGGTTGATACCC
CGGACTTTGTAGGATATTT -> GGACTTTGTAGGATATTTT
CGGAGAAATCAATACAGCA -> GGAGAAATCAATACAGCAA
CGGATCCCCCACAAGATTT -> GGATCCCCCACAAGATTTC
CGGATTGTGGATCGAGAGA -> GGATTGTGGATCGAGAGAG
CGGCCGCGGTCTCAGGGTA -> GGCCGCGGTCTCAGGGTAC
CGGCGAGAATGGGAATCCG -> GGCGAGAATGGGAATCCGG
CGGCGCCTCGTTCAAATCG -> GGCGCCTCGTTCAAATCGG
CGGCTAATTAGAAAAACTC -> GGCTAATTAGAAAAACTCT
CGGCTAGCTGGCAACGGAC -> GGCTAGCTGGCAACGGACC
CGGCTAGTGGTAGCCTGGG -> GGCTAGTGGTAGCCTGGGT
CGGCTGCCATAAGCTTTTA -> GGCTGCCATAAGCTTTTAC
CGGCTTGGCCGCCTCCCAT -> GGCTTGGCCGCCTCCCATA
CGGGAAATACGGTGTTCTA -> GGGAAATACGGTGTTCTAC
CGGGACAAACGGGCGACCG -> GGGACAAACGGGCGACCGT
CGGGACCTATTTACTAAGG -> GGGACCTATTTACTAAGGT
CGGGAGTTTGTGCACCTGC -> GGGAGTTTGTGCACCTGCA
CGGGATTCGTATCTCTATG -> GGGATTCGTATCTCTATGT
CGGGCATCAATAATCCTCG -> GGGCATCAATAATCCTCGG
CGGGCGACCGTGGTTTGGC -> GGGCGACCGTGGTTTGGCA
CGGGCTCAAATTAGAACTA -> GGGCTCAAATTAGAACTAT
CGGGCTGGCGCACAGTTAT -> GGGCTGGCGCACAGTTATC
CGGGGCCATTCGGGTGCAA -> GGGGCCATTCGGGTGCAAA
CGGGTAACCGTGAGCCCGC -> GGGTAACCGTGAGCCCGCC
CGGGTCGCTCGATGCTCGT -> GGGTCGCTCGATGCTCGTA
CGGGTGCAAAGAGCCCACA -> GGGTGCAAAGAGCCCACAC
CGGTAATATTAAGTACCGG -> GGTAATATTAAGTACCGGG
CGGTACGCGGGCATCAATA -> GGTACGCGGGCATCAATAA
CGGTCTCAGGGTACGTAAA -> GGTCTCAGGGTACGTAAAT
CGGTGACCGCGACCCTTAA -> GGTGACCGCGACCCTTAAT
CGGTGAGAGGATCCGGACT -> GGTGAGAGGATCCGGACTT
CGGTGCGGCTAGCTGGCAA -> GGTGCGGCTAGCTGGCAAC
CGGTGTTCTACACGAAGTA -> GGTGTTCTACACGAAGTAA
CGGTTAGACATCGCGTTCC -> GGTTAGACATCGCGTTCCA
CGGTTGGCGCGATCATTTA -> GGTTGGCGCGATCATTTAC
CGGTTTATGAGAGGGTCTG -> GGTTTATGAGAGGGTCTGA
CGGTTTTGTTAAGACTAAC -> GGTTTTGTTAAGACTAACG
CGTAAACTCTGTTGTGCAG -> GTAAACTCTGTTGTGCAGG
CGTAAATCACACCTCTCAA -> GTAAATCACACCTCTCAAC
CGTAACCAAGGCATGAGGC -> GTAACCAAGGCATGAGGCG
CGTAAGAAGCGAAGTTTAG -> GTAAGAAGCGAAGTTTAGA
CGTAATGGAAGCCAGAACC -> GTAATGGAAGCCAGAACCG
CGTAATTTGCGCACACATA -> GTAATTTGCGCACACATAC
CGTACGTGGGGAGGCGTTT -> GTACGTGGGGAGGCGTTTC
CGTAGGTCCAGCCCCGGTT -> GTAGGTCCAGCCCCGGTTG
CGTATAACCTTAAGACGGT -> GTATAACCTTAAGACGGTT
CGTATCCGGGGCCATTCGG -> GTATCCGGGGCCATTCGGG
CGTATCTCTATGTGAGGTC -> GTATCTCTATGTGAGGTCG
CGTATTTAATCTCCATTTC -> GTATTTAATCTCCATTTCT
CGTCCTTTCCAACGCCATT -> GTCCTTTCCAACGCCATTG
CGTCTCCTTACGATATTGT -> GTCTCCTTACGATATTGTT
CGTCTGCGGATCCCCCACA -> GTCTGCGGATCCCCCACAA
CGTGACAGTGTATATAACG -> GTGACAGTGTATATAACGG
CGTGAGCCCGCCTACGCCC -> GTGAGCCCGCCTACGCCCA
CGTGATCTAGATAGTTTTA -> GTGATCTAGATAGTTTTAA
CGTGATGTAGTCCCTAAAC -> GTGATGTAGTCCCTAAACC
CGTGCTAAAGCCTTTAGAG -> GTGCTAAAGCCTTTAGAGG
CGTGGGGAGGCGTTTCAGG -> GTGGGGAGGCGTTTCAGGC
CGTGGTTTGGCACATTAAG -> GTGGTTTGGCACATTAAGT
CGTGTCATTTAAGTAGGAA -> GTGTCATTTAAGTAGGAAG
CGTGTCCCAGCAGGGCGAG -> GTGTCCCAGCAGGGCGAGG
CGTTAGGCATTTACCCCCC -> GTTAGGCATTTACCCCCCG
CGTTATCTCCAATCGGCGA -> GTTATCTCCAATCGGCGAG
CGTTCAAATCGGGAAATAC -> GTTCAAATCGGGAAATACG
CGTTCAGGAGTCTTGAGCG -> GTTCAGGAGTCTTGAGCGT
CGTTCCATAATGCGTATTT -> GTTCCATAATGCGTATTTA
CGTTCGGCTAGTGGTAGCC -> GTTCGGCTAGTGGTAGCCT
CGTTGTGCGCCAACTCTTC -> GTTGTGCGCCAACTCTTCG
CGTTTCAGGCAATTACAAA -> GTTTCAGGCAATTACAAAT
CGTTTCTGGGGTAGCGCTT -> GTTTCTGGGGTAGCGCTTA
CTAAACCGCTCGCAGAATA -> TAAACCGCTCGCAGAATAA
CTAAACCGCTCGCAGAATC -> TAAACCGCTCGCAGAATCA
CTAAACCGCTCGCAGAATT -> TAAACCGCTCGCAGAATTG,TAAACCGCTCGCAGAATTA
CTAAACTCCATTCTGAGCG -> TAAACTCCATTCTGAGCGA
CTAAAGCCTTTAGAGGTAC -> TAAAGCCTTTAGAGGTACG
CTAACGAGTTACCCATATT -> TAACGAGTTACCCATATTA
CTAAGCGTGATCTAGATAG -> TAAGCGTGATCTAGATAGT
CTAAGGTCACGCTATGCGC -> TAAGGTCACGCTATGCGCT
CTAAGTCTCACCCGCCGGT -> TAAGTCTCACCCGCCGGTT
CTAATGAGGATGAGCCATA -> TAATGAGGATGAGCCATAT
CTAATTAGAAAAACTCTTA -> TAATTAGAAAAACTCTTAG
CTACACGAAGTAAGTCGCT -> TACACGAAGTAAGTCGCTG
CTACAGAGTCCCTAAACCG -> TACAGAGTCCCTAAACCGC
CTACGCCCATGTTCCTAAG -> TACGCCCATGTTCCTAAGT
CTACGTTAGGCATTTACCC -> TACGTTAGGCATTTACCCC
CTACTTGGGCTTTTAACAG -> TACTTGGGCTTTTAACAGG
CTAGATAGTTTTAAGGAGT -> TAGATAGTTTTAAGGAGTG
CTAGCCCCGGGTAACCGTG -> TAGCCCCGGGTAACCGTGA
CTAGCGTCTCCTTACGATA -> TAGCGTCTCCTTACGATAT
CTAGCTGGCAACGGACCCA -> TAGCTGGCAACGGACCCAA
CTAGGAATTAGTGTCTACG -> TAGGAATTAGTGTCTACGT
CTAGTGGTAGCCTGGGTAT -> TAGTGGTAGCCTGGGTATC
CTATAATCTATGTGTCACA -> TATAATCTATGTGTCACAC
CTATGCGCTCGGGCTGGCG -> TATGCGCTCGGGCTGGCGC
CTATGTGAGGTCGCGACAC -> TATGTGAGGTCGCGACACC
CTATGTGTCACACAGGGTG -> TATGTGTCACACAGGGTGT
CTATTGGTCCGCCGAGTCG -> TATTGGTCCGCCGAGTCGC
CTATTTACTAAGGTCACGC -> TATTTACTAAGGTCACGCT
CTCAAATTAGAACTATAAT -> TCAAATTAGAACTATAATC
CTCAACAAGTGAGGAATGC -> TCAACAAGTGAGGAATGCG
CTCAATAGCGGCGCCTCGT -> TCAATAGCGGCGCCTCGTT
CTCACCCGCCGGTTAGACA -> TCACCCGCCGGTTAGACAT
CTCAGGGTACGTAAATCAC -> TCAGGGTACGTAAATCACA
CTCATTGAAGTTGGGATGC -> TCATTGAAGTTGGGATGCG
CTCATTTTGAGTGGAAACC -> TCATTTTGAGTGGAAACCG
CTCCAATCGGCGAGAATGG -> TCCAATCGGCGAGAATGGG
CTCCATTCTGAGCGACGCA -> TCCATTCTGAGCGACGCAT
CTCCATTTCTGGTAATGGG -> TCCATTTCTGGTAATGGGC
CTCCCATAGACGTCTGCGG -> TCCCATAGACGTCTGCGGA
CTCCTTACGATATTGTTAG -> TCCTTACGATATTGTTAGA
CTCGATGCTCGTAAGAAGC -> TCGATGCTCGTAAGAAGCG
CTCGCAGAATAAGCCTGCG -> TCGCAGAATAAGCCTGCGA
CTCGCAGAATCAGGGATAG -> TCGCAGAATCAGGGATAGG
CTCGCAGAATTATCTGGGC -> TCGCAGAATTATCTGGGCT
CTCGCAGAATTGTACTAAG -> TCGCAGAATTGTACTAAGC
CTCGGAGAAATCAATACAG -> TCGGAGAAATCAATACAGC
CTCGGGCTGGCGCACAGTT -> TCGGGCTGGCGCACAGTTA
CTCGGTAATATTAAGTACC -> TCGGTAATATTAAGTACCG
CTCGTAAGAAGCGAAGTTT -> TCGTAAGAAGCGAAGTTTA
CTCGTTCAAATCGGGAAAT -> TCGTTCAAATCGGGAAATA
CTCTACAGAGTCCCTAAAC -> TCTACAGAGTCCCTAAACC
CTCTATGTGAGGTCGCGAC -> TCTATGTGAGGTCGCGACA
CTCTCAACAAGTGAGGAAT -> TCTCAACAAGTGAGGAATG
CTCTCATTGAAGTTGGGAT -> TCTCATTGAAGTTGGGATG
CTCTGTTGTGCAGGATAAG -> TCTGTTGTGCAGGATAAGC
CTCTTAGGGGTACATTCGG -> TCTTAGGGGTACATTCGGT
CTCTTAGTGTAGTATTACC -> TCTTAGTGTAGTATTACCT
CTCTTCGGGACCTATTTAC -> TCTTCGGGACCTATTTACT
CTGACCGATGTTCAGAAAT -> TGACCGATGTTCAGAAATC
CTGAGCGACGCATTGTAAT -> TGAGCGACGCATTGTAATG
CTGAGGAAGTTGTCTCGGA -> TGAGGAAGTTGTCTCGGAG
CTGAGTCAAAGCGAATGAT -> TGAGTCAAAGCGAATGATG
CTGCACGTGTCATTTAAGT -> TGCACGTGTCATTTAAGTA
CTGCCATAAGCTTTTACCC -> TGCCATAAGCTTTTACCCT
CTGCGACCGTAATTTGCGC -> TGCGACCGTAATTTGCGCA
CTGCGGATCCCCCACAAGA -> TGCGGATCCCCCACAAGAT
CTGCGTACGTGGGGAGGCG -> TGCGTACGTGGGGAGGCGT
CTGCGTAGGTCCAGCCCCG -> TGCGTAGGTCCAGCCCCGG
CTGGCAACGGACCCAAAGA -> TGGCAACGGACCCAAAGAG
CTGGCCAGTGGACGTTTCT -> TGGCCAGTGGACGTTTCTG
CTGGCGCACAGTTATCATC -> TGGCGCACAGTTATCATCG
CTGGCTCATTTTGAGTGGA -> TGGCTCATTTTGAGTGGAA
CTGGGCGAAACCCTAAACC -> TGGGCGAAACCCTAAACCG
CTGGGCTTAGAGGCTTTCA -> TGGGCTTAGAGGCTTTCAT
CTGGGGTAGCGCTTACCGT -> TGGGGTAGCGCTTACCGTA
CTGGGTATCTGTTTCAGAC -> TGGGTATCTGTTTCAGACC
CTGGTAATGGGCGCGGTGA -> TGGTAATGGGCGCGGTGAG
CTGGTGAGAAAACTCTTAG -> TGGTGAGAAAACTCTTAGG
CTGGTTGATACCCCGTTGT -> TGGTTGATACCCCGTTGTG
CTGTACGCTGAGTCAAAGC -> TGTACGCTGAGTCAAAGCG
CTGTCGGGAGTTTGTGCAC -> TGTCGGGAGTTTGTGCACC
CTGTGGTTAGACGCATCCC -> TGTGGTTAGACGCATCCCG
CTGTTGTGCAGGATAAGCT -> TGTTGTGCAGGATAAGCTT
CTGTTTCAGACCCCCACTT -> TGTTTCAGACCCCCACTTC
CTTAACAGCTGGCCAGTGG -> TTAACAGCTGGCCAGTGGA
CTTAAGACGGTTTTGTTAA -> TTAAGACGGTTTTGTTAAG
CTTAATAGTAAGAGTCAGC -> TTAATAGTAAGAGTCAGCT
CTTACCGTAAACTCTGTTG -> TTACCGTAAACTCTGTTGT
CTTACGATATTGTTAGAAA -> TTACGATATTGTTAGAAAT
CTTAGAGGCTTTCATGATT -> TTAGAGGCTTTCATGATTG
CTTAGGGGTACATTCGGTT -> TTAGGGGTACATTCGGTTT
CTTAGTGTAGTATTACCTG -> TTAGTGTAGTATTACCTGG
CTTCAAGAGTAAAGATCGC -> TTCAAGAGTAAAGATCGCG
CTTCAGCGAAACAGCCGAA -> TTCAGCGAAACAGCCGAAG
CTTCCAGGACACCAGATGC -> TTCCAGGACACCAGATGCG
CTTCCTGTGGTTAGACGCA -> TTCCTGTGGTTAGACGCAT
CTTCGGGACCTATTTACTA -> TTCGGGACCTATTTACTAA
CTTCGGGTCGCTCGATGCT -> TTCGGGTCGCTCGATGCTC
CTTCTTCAAGAGTAAAGAT -> TTCTTCAAGAGTAAAGATC
CTTGACCGGTGCGGCTAGC -> TTGACCGGTGCGGCTAGCT
CTTGAGCGTGCTAAAGCCT -> TTGAGCGTGCTAAAGCCTT
CTTGCACTAGCGTCTCCTT -> TTGCACTAGCGTCTCCTTA
CTTGCGCACTGGCTCATTT -> TTGCGCACTGGCTCATTTT
CTTGGCCGCCTCCCATAGA -> TTGGCCGCCTCCCATAGAC
CTTGGGCTTTTAACAGGCC -> TTGGGCTTTTAACAGGCCC
CTTTAGAGGTACGCGAGGC -> TTTAGAGGTACGCGAGGCG
CTTTCATGATTGCAGAGGA -> TTTCATGATTGCAGAGGAC
CTTTCCAACGCCATTGACG -> TTTCCAACGCCATTGACGA
CTTTCGCGGTGACCGCGAC -> TTTCGCGGTGACCGCGACC
CTTTCGGCCGCGGTCTCAG -> TTTCGGCCGCGGTCTCAGG
CTTTGTAGGATATTTTAGG -> TTTGTAGGATATTTTAGGA
CTTTTAACAGGCCCATACC -> TTTTAACAGGCCCATACCG
CTTTTACCCTAGGAATTAG -> TTTTACCCTAGGAATTAGT
CTTTTCGCAGGGAATAACG -> TTTTCGCAGGGAATAACGC
CTTTTGAAGGTTAGGTGTA -> TTTTGAAGGTTAGGTGTAC
GAAAAACTCTTAGTGTAGT -> AAAAACTCTTAGTGTAGTA
GAAAACTCTTAGGGGTACA -> AAAACTCTTAGGGGTACAT
GAAACAGCCGAAGGAATTC -> AAACAGCCGAAGGAATTCC
GAAACCCTAAACCGCTCGC -> AAACCCTAAACCGCTCGCA
GAAACCGCAGAGTTCGAGC -> AAACCGCAGAGTTCGAGCG
GAAATACGGTGTTCTACAC -> AAATACGGTGTTCTACACG
GAAATCAATACAGCAACAA -> AAATCAATACAGCAACAAA
GAAATCAATACAGCAACCT -> AAATCAATACAGCAACCTG
GAAATCAATACAGCAACGT -> AAATCAATACAGCAACGTG
GAAATCAATACAGCAACTC -> AAATCAATACAGCAACTCT
GAACAAACAAGACAGTTGG -> AACAAACAAGACAGTTGGC
GAACCGTATAACCTTAAGA -> AACCGTATAACCTTAAGAC
GAACCGTTCGGCTAGTGGT -> AACCGTTCGGCTAGTGGTA
GAACCTTCTTCAAGAGTAA -> AACCTTCTTCAAGAGTAAA
GAACTATAATCTATGTGTC -> AACTATAATCTATGTGTCA
GAACTTCAGCGAAACAGCC -> AACTTCAGCGAAACAGCCG
GAAGAAATCAATACAGCAA -> AAGAAATCAATACAGCAAC
GAAGAACCTTCTTCAAGAG -> AAGAACCTTCTTCAAGAGT
GAAGCCAGAACCGTTCGGC -> AAGCCAGAACCGTTCGGCT
GAAGCGAAGTTTAGACTCT -> AAGCGAAGTTTAGACTCTC
GAAGGAATTCCGTCCTTTC -> AAGGAATTCCGTCCTTTCC
GAAGGGTGGCGTTCAGGAG -> AAGGGTGGCGTTCAGGAGT
GAAGGTTAGGTGTACTGCG -> AAGGTTAGGTGTACTGCGT
GAAGTAAGTCGCTGACCGA -> AAGTAAGTCGCTGACCGAT
GAAGTGCATCATCTGTACG -> AAGTGCATCATCTGTACGC
GAAGTTGGGATGCGTGTCC -> AAGTTGGGATGCGTGTCCC
GAAGTTGTCTCGGAGAAAT -> AAGTTGTCTCGGAGAAATC
GAAGTTTAGACTCTCATTG -> AAGTTTAGACTCTCATTGA
GAATAACGCCTAAACTCCA -> AATAACGCCTAAACTCCAT
GAATAAGCCTGCGACCGTA -> AATAAGCCTGCGACCGTAA
GAATCAGGGATAGGGCAGT -> AATCAGGGATAGGGCAGTA
GAATCCGGTACGCGGGCAT -> AATCCGGTACGCGGGCATC
GAATGATGGTCTGCGTAGG -> AATGATGGTCTGCGTAGGT
GAATGCGAACAAACAAGAC -> AATGCGAACAAACAAGACA
GAATGGGAATCCGGTACGC -> AATGGGAATCCGGTACGCG
GAATTAGTGTCTACGTTAG -> AATTAGTGTCTACGTTAGG
GAATTATCTGGGCTTAGAG -> AATTATCTGGGCTTAGAGG
GAATTCCGTCCTTTCCAAC -> AATTCCGTCCTTTCCAACG
GAATTGTACTAAGCGTGAT -> AATTGTACTAAGCGTGATC
GACAAACGGGCGACCGTGG -> ACAAACGGGCGACCGTGGT
GACACCAGATGCGAGTAGA -> ACACCAGATGCGAGTAGAT
GACACCTGTCGGGAGTTTG -> ACACCTGTCGGGAGTTTGT
GACACTTTCGGCCGCGGTC -> ACACTTTCGGCCGCGGTCT
GACAGTGTATATAACGGAC -> ACAGTGTATATAACGGACC
GACAGTTGGCCGGCTTGGC -> ACAGTTGGCCGGCTTGGCC
GACATCGCGTTCCATAATG -> ACATCGCGTTCCATAATGC
GACCCAAAGAGAAGAACCT -> ACCCAAAGAGAAGAACCTT
GACCCCCACTTCGGGTCGC -> ACCCCCACTTCGGGTCGCT
GACCCCCGCGCGATATAAG -> ACCCCCGCGCGATATAAGC
GACCCGCACCTAAACCGCT -> ACCCGCACCTAAACCGCTC
GACCCTTAATAGTAAGAGT -> ACCCTTAATAGTAAGAGTC
GACCGATGTTCAGAAATCA -> ACCGATGTTCAGAAATCAA
GACCGCGACCCTTAATAGT -> ACCGCGACCCTTAATAGTA
GACCGCTGGTTGATACCCC -> ACCGCTGGTTGATACCCCG
GACCGGTGCGGCTAGCTGG -> ACCGGTGCGGCTAGCTGGC
GACCGTAATTTGCGCACAC -> ACCGTAATTTGCGCACACA
GACCGTGGTTTGGCACATT -> ACCGTGGTTTGGCACATTA
GACCTATTTACTAAGGTCA -> ACCTATTTACTAAGGTCAC
GACCTTTTGAAGGTTAGGT -> ACCTTTTGAAGGTTAGGTG
GACGACCTTTTGAAGGTTA -> ACGACCTTTTGAAGGTTAG
GACGCATCCCGTATCCGGG -> ACGCATCCCGTATCCGGGG
GACGCATTGTAATGCTTGA -> ACGCATTGTAATGCTTGAC
GACGGTTTTGTTAAGACTA -> ACGGTTTTGTTAAGACTAA
GACGTCTGCGGATCCCCCA -> ACGTCTGCGGATCCCCCAC
GACGTTTCTGGGGTAGCGC -> ACGTTTCTGGGGTAGCGCT
GACTAACGAGTTACCCATA -> ACTAACGAGTTACCCATAT
GACTAATGAGGATGAGCCA -> ACTAATGAGGATGAGCCAT
GACTATTGGTCCGCCGAGT -> ACTATTGGTCCGCCGAGTC
GACTCTCATTGAAGTTGGG -> ACTCTCATTGAAGTTGGGA
GACTTTGTAGGATATTTTA -> ACTTTGTAGGATATTTTAG
GAGAAAACTCTTAGGGGTA -> AGAAAACTCTTAGGGGTAC
GAGAAATCAATACAGCAAC -> AGAAATCAATACAGCAACG
GAGAACTTCAGCGAAACAG -> AGAACTTCAGCGAAACAGC
GAGAAGAACCTTCTTCAAG -> AGAAGAACCTTCTTCAAGA
GAGAATGGGAATCCGGTAC -> AGAATGGGAATCCGGTACG
GAGAGAACTTCAGCGAAAC -> AGAGAACTTCAGCGAAACA
GAGAGAGAACTTCAGCGAA -> AGAGAGAACTTCAGCGAAA
GAGAGGATCCGGACTTTGT -> AGAGGATCCGGACTTTGTA
GAGAGGGTCTGAGGAAGTT -> AGAGGGTCTGAGGAAGTTG
GAGCCATATATTCAACCGA -> AGCCATATATTCAACCGAT
GAGCCCACACCGGCTGCCA -> AGCCCACACCGGCTGCCAT
GAGCCCGCCTACGCCCATG -> AGCCCGCCTACGCCCATGT
GAGCGACGCATTGTAATGC -> AGCGACGCATTGTAATGCT
GAGCGCTCAATAGCGGCGC -> AGCGCTCAATAGCGGCGCC
GAGCGTGCTAAAGCCTTTA -> AGCGTGCTAAAGCCTTTAG
GAGGAAGTTGTCTCGGAGA -> AGGAAGTTGTCTCGGAGAA
GAGGAATGCGAACAAACAA -> AGGAATGCGAACAAACAAG
GAGGACTATTGGTCCGCCG -> AGGACTATTGGTCCGCCGA
GAGGATCCGGACTTTGTAG -> AGGATCCGGACTTTGTAGG
GAGGATGAGCCATATATTC -> AGGATGAGCCATATATTCA
GAGGCGTAATGGAAGCCAG -> AGGCGTAATGGAAGCCAGA
GAGGCGTGACAGTGTATAT -> AGGCGTGACAGTGTATATA
GAGGCGTTTCAGGCAATTA -> AGGCGTTTCAGGCAATTAC
GAGGCTTTCATGATTGCAG -> AGGCTTTCATGATTGCAGA
GAGGGTCTGAGGAAGTTGT -> AGGGTCTGAGGAAGTTGTC
GAGGTACGCGAGGCGTGAC -> AGGTACGCGAGGCGTGACA
GAGGTCATAATAGGGCTTG -> AGGTCATAATAGGGCTTGC
GAGGTCGCGACACCTGTCG -> AGGTCGCGACACCTGTCGG
GAGTAAAGATCGCGATATG -> AGTAAAGATCGCGATATGG
GAGTAGATGATTCGGATTG -> AGTAGATGATTCGGATTGT
GAGTCAAAGCGAATGATGG -> AGTCAAAGCGAATGATGGT
GAGTCAGCTACTTGGGCTT -> AGTCAGCTACTTGGGCTTT
GAGTCCCTAAACCGCTCGC -> AGTCCCTAAACCGCTCGCA
GAGTCGCTTTTCGCAGGGA -> AGTCGCTTTTCGCAGGGAA
GAGTCTTGAGCGTGCTAAA -> AGTCTTGAGCGTGCTAAAG
GAGTGGAAACCGCAGAGTT -> AGTGGAAACCGCAGAGTTC
GAGTGGAACCGTATAACCT -> AGTGGAACCGTATAACCTT
GAGTTACCCATATTAGAAG -> AGTTACCCATATTAGAAGT
GAGTTCGAGCGCTCAATAG -> AGTTCGAGCGCTCAATAGC
GAGTTTGTGCACCTGCACG -> AGTTTGTGCACCTGCACGT
GATAAGCTTCCTGTGGTTA -> ATAAGCTTCCTGTGGTTAG
GATACCCCGTTGTGCGCCA -> ATACCCCGTTGTGCGCCAA
GATAGGGCAGTATCCCCGG -> ATAGGGCAGTATCCCCGGC
GATAGTTTTAAGGAGTGGA -> ATAGTTTTAAGGAGTGGAA
GATATAAGCTTAACAGCTG -> ATATAAGCTTAACAGCTGG
GATATGGTGTGTAAATTTG -> ATATGGTGTGTAAATTTGA
GATATTGTTAGAAATCAAT -> ATATTGTTAGAAATCAATA
GATATTTTAGGACCCCCGC -> ATATTTTAGGACCCCCGCG
GATCATTTACTAGCCCCGG -> ATCATTTACTAGCCCCGGG
GATCCCCCACAAGATTTCA -> ATCCCCCACAAGATTTCAA
GATCCGGACTTTGTAGGAT -> ATCCGGACTTTGTAGGATA
GATCGAGAGAGAACTTCAG -> ATCGAGAGAGAACTTCAGC
GATCGCGATATGGTGTGTA -> ATCGCGATATGGTGTGTAA
GATCGTAACCAAGGCATGA -> ATCGTAACCAAGGCATGAG
GATCTAGATAGTTTTAAGG -> ATCTAGATAGTTTTAAGGA
GATGAAGGGTGGCGTTCAG -> ATGAAGGGTGGCGTTCAGG
GATGAGCCATATATTCAAC -> ATGAGCCATATATTCAACC
GATGATTCGGATTGTGGAT -> ATGATTCGGATTGTGGATC
GATGCGAGTAGATGATTCG -> ATGCGAGTAGATGATTCGG
GATGCGTGTCCCAGCAGGG -> ATGCGTGTCCCAGCAGGGC
GATGCTCGTAAGAAGCGAA -> ATGCTCGTAAGAAGCGAAG
GATGGTCTGCGTAGGTCCA -> ATGGTCTGCGTAGGTCCAG
GATGTAGTCCCTAAACCGC -> ATGTAGTCCCTAAACCGCT
GATGTTCAGAAATCAATAC -> ATGTTCAGAAATCAATACA
GATTCGGATTGTGGATCGA -> ATTCGGATTGTGGATCGAG
GATTCGTATCTCTATGTGA -> ATTCGTATCTCTATGTGAG
GATTGCAGAGGACTATTGG -> ATTGCAGAGGACTATTGGT
GATTGTGGATCGAGAGAGA -> ATTGTGGATCGAGAGAGAA
GATTTCAATAGTGATCGTA -> ATTTCAATAGTGATCGTAA
GATTTGACTAATGAGGATG -> ATTTGACTAATGAGGATGA
GCAAAGAGCCCACACCGGC -> CAAAGAGCCCACACCGGCT
GCAACAAAGACCCGCACCT -> CAACAAAGACCCGCACCTA
GCAACCTGGGCGAAACCCT -> CAACCTGGGCGAAACCCTA
GCAACGGACCCAAAGAGAA -> CAACGGACCCAAAGAGAAG
GCAACGTGATGTAGTCCCT -> CAACGTGATGTAGTCCCTA
GCAACTCTACAGAGTCCCT -> CAACTCTACAGAGTCCCTA
GCAATTACAAATGTGTTAT -> CAATTACAAATGTGTTATG
GCACACATACTTGCACTAG -> CACACATACTTGCACTAGC
GCACAGTTATCATCGTTAT -> CACAGTTATCATCGTTATC
GCACATTAAGTTAACCTTC -> CACATTAAGTTAACCTTCC
GCACCTAAACCGCTCGCAG -> CACCTAAACCGCTCGCAGA
GCACCTGCACGTGTCATTT -> CACCTGCACGTGTCATTTA
GCACGTGTCATTTAAGTAG -> CACGTGTCATTTAAGTAGG
GCACTAGCGTCTCCTTACG -> CACTAGCGTCTCCTTACGA
GCACTGGCTCATTTTGAGT -> CACTGGCTCATTTTGAGTG
GCAGAATAAGCCTGCGACC -> CAGAATAAGCCTGCGACCG
GCAGAATCAGGGATAGGGC -> CAGAATCAGGGATAGGGCA
GCAGAATTATCTGGGCTTA -> CAGAATTATCTGGGCTTAG
GCAGAATTGTACTAAGCGT -> CAGAATTGTACTAAGCGTG
GCAGAGGACTATTGGTCCG -> CAGAGGACTATTGGTCCGC
GCAGAGTTCGAGCGCTCAA -> CAGAGTTCGAGCGCTCAAT
GCAGGATAAGCTTCCTGTG -> CAGGATAAGCTTCCTGTGG
GCAGGGAATAACGCCTAAA -> CAGGGAATAACGCCTAAAC
GCAGGGCGAGGTCATAATA -> CAGGGCGAGGTCATAATAG
GCAGTATCCCCGGCTAATT -> CAGTATCCCCGGCTAATTA
GCATCAATAATCCTCGGTA -> CATCAATAATCCTCGGTAA
GCATCATCTGTACGCTGAG -> CATCATCTGTACGCTGAGT
GCATCCCGTATCCGGGGCC -> CATCCCGTATCCGGGGCCA
GCATGAGGCGTAATGGAAG -> CATGAGGCGTAATGGAAGC
GCATTGTAATGCTTGACCG -> CATTGTAATGCTTGACCGG
GCATTTACCCCCCGCGATT -> CATTTACCCCCCGCGATTT
GCCAACTCTTCGGGACCTA -> CCAACTCTTCGGGACCTAT
GCCAGAACCGTTCGGCTAG -> CCAGAACCGTTCGGCTAGT
GCCAGTATTAGTGTCAGGT -> CCAGTATTAGTGTCAGGTC
GCCAGTGGACGTTTCTGGG -> CCAGTGGACGTTTCTGGGG
GCCATAAGCTTTTACCCTA -> CCATAAGCTTTTACCCTAG
GCCATATATTCAACCGATG -> CCATATATTCAACCGATGA
GCCATTCGGGTGCAAAGAG -> CCATTCGGGTGCAAAGAGC
GCCATTGACGACCTTTTGA -> CCATTGACGACCTTTTGAA
GCCCACACCGGCTGCCATA -> CCCACACCGGCTGCCATAA
GCCCATACCGGGACAAACG -> CCCATACCGGGACAAACGG
GCCCATGTTCCTAAGTCTC -> CCCATGTTCCTAAGTCTCA
GCCCCGGGTAACCGTGAGC -> CCCCGGGTAACCGTGAGCC
GCCCCGGTTGGCGCGATCA -> CCCCGGTTGGCGCGATCAT
GCCCGCCTACGCCCATGTT -> CCCGCCTACGCCCATGTTC
GCCGAAGGAATTCCGTCCT -> CCGAAGGAATTCCGTCCTT
GCCGAGTCGCTTTTCGCAG -> CCGAGTCGCTTTTCGCAGG
GCCGCCTCCCATAGACGTC -> CCGCCTCCCATAGACGTCT
GCCGCGGTCTCAGGGTACG -> CCGCGGTCTCAGGGTACGT
GCCGGCTTGGCCGCCTCCC -> CCGGCTTGGCCGCCTCCCA
GCCGGTTAGACATCGCGTT -> CCGGTTAGACATCGCGTTC
GCCTAAACTCCATTCTGAG -> CCTAAACTCCATTCTGAGC
GCCTACGCCCATGTTCCTA -> CCTACGCCCATGTTCCTAA
GCCTCCCATAGACGTCTGC -> CCTCCCATAGACGTCTGCG
GCCTCGTTCAAATCGGGAA -> CCTCGTTCAAATCGGGAAA
GCCTGCGACCGTAATTTGC -> CCTGCGACCGTAATTTGCG
GCCTGGGTATCTGTTTCAG -> CCTGGGTATCTGTTTCAGA
GCCTTTAGAGGTACGCGAG -> CCTTTAGAGGTACGCGAGG
GCGAAACAGCCGAAGGAAT -> CGAAACAGCCGAAGGAATT
GCGAAACCCTAAACCGCTC -> CGAAACCCTAAACCGCTCG
GCGAACAAACAAGACAGTT -> CGAACAAACAAGACAGTTG
GCGAAGTTTAGACTCTCAT -> CGAAGTTTAGACTCTCATT
GCGAATGATGGTCTGCGTA -> CGAATGATGGTCTGCGTAG
GCGACACCTGTCGGGAGTT -> CGACACCTGTCGGGAGTTT
GCGACCCTTAATAGTAAGA -> CGACCCTTAATAGTAAGAG
GCGACCGTAATTTGCGCAC -> CGACCGTAATTTGCGCACA
GCGACCGTGGTTTGGCACA -> CGACCGTGGTTTGGCACAT
GCGACGCATTGTAATGCTT -> CGACGCATTGTAATGCTTG
GCGAGAATGGGAATCCGGT -> CGAGAATGGGAATCCGGTA
GCGAGGCGTGACAGTGTAT -> CGAGGCGTGACAGTGTATA
GCGAGGTCATAATAGGGCT -> CGAGGTCATAATAGGGCTT
GCGAGTAGATGATTCGGAT -> CGAGTAGATGATTCGGATT
GCGATATAAGCTTAACAGC -> CGATATAAGCTTAACAGCT
GCGATATGGTGTGTAAATT -> CGATATGGTGTGTAAATTT
GCGATCATTTACTAGCCCC -> CGATCATTTACTAGCCCCG
GCGATTTGACTAATGAGGA -> CGATTTGACTAATGAGGAT
GCGCACACATACTTGCACT -> CGCACACATACTTGCACTA
GCGCACAGTTATCATCGTT -> CGCACAGTTATCATCGTTA
GCGCACTGGCTCATTTTGA -> CGCACTGGCTCATTTTGAG
GCGCCAACTCTTCGGGACC -> CGCCAACTCTTCGGGACCT
GCGCCTCGTTCAAATCGGG -> CGCCTCGTTCAAATCGGGA
GCGCGATATAAGCTTAACA -> CGCGATATAAGCTTAACAG
GCGCGATCATTTACTAGCC -> CGCGATCATTTACTAGCCC
GCGCGGTGAGAGGATCCGG -> CGCGGTGAGAGGATCCGGA
GCGCTCAATAGCGGCGCCT -> CGCTCAATAGCGGCGCCTC
GCGCTCGGGCTGGCGCACA -> CGCTCGGGCTGGCGCACAG
GCGCTTACCGTAAACTCTG -> CGCTTACCGTAAACTCTGT
GCGGATCCCCCACAAGATT -> CGGATCCCCCACAAGATTT
GCGGCGCCTCGTTCAAATC -> CGGCGCCTCGTTCAAATCG
GCGGCTAGCTGGCAACGGA -> CGGCTAGCTGGCAACGGAC
GCGGGCATCAATAATCCTC -> CGGGCATCAATAATCCTCG
GCGGTCTCAGGGTACGTAA -> CGGTCTCAGGGTACGTAAA
GCGGTGACCGCGACCCTTA -> CGGTGACCGCGACCCTTAA
GCGGTGAGAGGATCCGGAC -> CGGTGAGAGGATCCGGACT
GCGTAATGGAAGCCAGAAC -> CGTAATGGAAGCCAGAACC
GCGTACGTGGGGAGGCGTT -> CGTACGTGGGGAGGCGTTT
GCGTAGGTCCAGCCCCGGT -> CGTAGGTCCAGCCCCGGTT
GCGTATTTAATCTCCATTT -> CGTATTTAATCTCCATTTC
GCGTCTCCTTACGATATTG -> CGTCTCCTTACGATATTGT
GCGTGACAGTGTATATAAC -> CGTGACAGTGTATATAACG
GCGTGATCTAGATAGTTTT -> CGTGATCTAGATAGTTTTA
GCGTGCTAAAGCCTTTAGA -> CGTGCTAAAGCCTTTAGAG
GCGTGTCCCAGCAGGGCGA -> CGTGTCCCAGCAGGGCGAG
GCGTTCAGGAGTCTTGAGC -> CGTTCAGGAGTCTTGAGCG
GCGTTCCATAATGCGTATT -> CGTTCCATAATGCGTATTT
GCGTTTCAGGCAATTACAA -> CGTTTCAGGCAATTACAAA
GCTAAAGCCTTTAGAGGTA -> CTAAAGCCTTTAGAGGTAC
GCTAATTAGAAAAACTCTT -> CTAATTAGAAAAACTCTTA
GCTACTTGGGCTTTTAACA -> CTACTTGGGCTTTTAACAG
GCTAGCTGGCAACGGACCC -> CTAGCTGGCAACGGACCCA
GCTAGTGGTAGCCTGGGTA -> CTAGTGGTAGCCTGGGTAT
GCTATGCGCTCGGGCTGGC -> CTATGCGCTCGGGCTGGCG
GCTCAAATTAGAACTATAA -> CTCAAATTAGAACTATAAT
GCTCAATAGCGGCGCCTCG -> CTCAATAGCGGCGCCTCGT
GCTCATTTTGAGTGGAAAC -> CTCATTTTGAGTGGAAACC
GCTCGATGCTCGTAAGAAG -> CTCGATGCTCGTAAGAAGC
GCTCGCAGAATAAGCCTGC -> CTCGCAGAATAAGCCTGCG
GCTCGCAGAATCAGGGATA -> CTCGCAGAATCAGGGATAG
GCTCGCAGAATTATCTGGG -> CTCGCAGAATTATCTGGGC
GCTCGCAGAATTGTACTAA -> CTCGCAGAATTGTACTAAG
GCTCGGGCTGGCGCACAGT -> CTCGGGCTGGCGCACAGTT
GCTCGTAAGAAGCGAAGTT -> CTCGTAAGAAGCGAAGTTT
GCTGACCGATGTTCAGAAA -> CTGACCGATGTTCAGAAAT
GCTGAGTCAAAGCGAATGA -> CTGAGTCAAAGCGAATGAT
GCTGCCATAAGCTTTTACC -> CTGCCATAAGCTTTTACCC
GCTGGCAACGGACCCAAAG -> CTGGCAACGGACCCAAAGA
GCTGGCCAGTGGACGTTTC -> CTGGCCAGTGGACGTTTCT
GCTGGCGCACAGTTATCAT -> CTGGCGCACAGTTATCATC
GCTGGTTGATACCCCGTTG -> CTGGTTGATACCCCGTTGT
GCTTAACAGCTGGCCAGTG -> CTTAACAGCTGGCCAGTGG
GCTTACCGTAAACTCTGTT -> CTTACCGTAAACTCTGTTG
GCTTAGAGGCTTTCATGAT -> CTTAGAGGCTTTCATGATT
GCTTCCTGTGGTTAGACGC -> CTTCCTGTGGTTAGACGCA
GCTTGACCGGTGCGGCTAG -> CTTGACCGGTGCGGCTAGC
GCTTGCGCACTGGCTCATT -> CTTGCGCACTGGCTCATTT
GCTTGGCCGCCTCCCATAG -> CTTGGCCGCCTCCCATAGA
GCTTTCATGATTGCAGAGG -> CTTTCATGATTGCAGAGGA
GCTTTTAACAGGCCCATAC -> CTTTTAACAGGCCCATACC
GCTTTTACCCTAGGAATTA -> CTTTTACCCTAGGAATTAG
GCTTTTCGCAGGGAATAAC -> CTTTTCGCAGGGAATAACG
GGAAACCGCAGAGTTCGAG -> GAAACCGCAGAGTTCGAGC
GGAAATACGGTGTTCTACA -> GAAATACGGTGTTCTACAC
GGAACCGTATAACCTTAAG -> GAACCGTATAACCTTAAGA
GGAAGAAATCAATACAGCA -> GAAGAAATCAATACAGCAA
GGAAGCCAGAACCGTTCGG -> GAAGCCAGAACCGTTCGGC
GGAAGTTGTCTCGGAGAAA -> GAAGTTGTCTCGGAGAAAT
GGAATAACGCCTAAACTCC -> GAATAACGCCTAAACTCCA
GGAATCCGGTACGCGGGCA -> GAATCCGGTACGCGGGCAT
GGAATGCGAACAAACAAGA -> GAATGCGAACAAACAAGAC
GGAATTAGTGTCTACGTTA -> GAATTAGTGTCTACGTTAG
GGAATTCCGTCCTTTCCAA -> GAATTCCGTCCTTTCCAAC
GGACAAACGGGCGACCGTG -> GACAAACGGGCGACCGTGG
GGACACCAGATGCGAGTAG -> GACACCAGATGCGAGTAGA
GGACCCAAAGAGAAGAACC -> GACCCAAAGAGAAGAACCT
GGACCCCCGCGCGATATAA -> GACCCCCGCGCGATATAAG
GGACCGCTGGTTGATACCC -> GACCGCTGGTTGATACCCC
GGACCTATTTACTAAGGTC -> GACCTATTTACTAAGGTCA
GGACGTTTCTGGGGTAGCG -> GACGTTTCTGGGGTAGCGC
GGACTATTGGTCCGCCGAG -> GACTATTGGTCCGCCGAGT
GGACTTTGTAGGATATTTT -> GACTTTGTAGGATATTTTA
GGAGAAATCAATACAGCAA -> GAGAAATCAATACAGCAAC
GGAGGCGTTTCAGGCAATT -> GAGGCGTTTCAGGCAATTA
GGAGTCTTGAGCGTGCTAA -> GAGTCTTGAGCGTGCTAAA
GGAGTGGAACCGTATAACC -> GAGTGGAACCGTATAACCT
GGAGTTTGTGCACCTGCAC -> GAGTTTGTGCACCTGCACG
GGATAAGCTTCCTGTGGTT -> GATAAGCTTCCTGTGGTTA
GGATAGGGCAGTATCCCCG -> GATAGGGCAGTATCCCCGG
GGATATTTTAGGACCCCCG -> GATATTTTAGGACCCCCGC
GGATCCCCCACAAGATTTC -> GATCCCCCACAAGATTTCA
GGATCCGGACTTTGTAGGA -> GATCCGGACTTTGTAGGAT
GGATCGAGAGAGAACTTCA -> GATCGAGAGAGAACTTCAG
GGATGAGCCATATATTCAA -> GATGAGCCATATATTCAAC
GGATGCGTGTCCCAGCAGG -> GATGCGTGTCCCAGCAGGG
GGATTCGTATCTCTATGTG -> GATTCGTATCTCTATGTGA
GGATTGTGGATCGAGAGAG -> GATTGTGGATCGAGAGAGA
GGCAACGGACCCAAAGAGA -> GCAACGGACCCAAAGAGAA
GGCAATTACAAATGTGTTA -> GCAATTACAAATGTGTTAT
GGCACATTAAGTTAACCTT -> GCACATTAAGTTAACCTTC
GGCAGTATCCCCGGCTAAT -> GCAGTATCCCCGGCTAATT
GGCATCAATAATCCTCGGT -> GCATCAATAATCCTCGGTA
GGCATGAGGCGTAATGGAA -> GCATGAGGCGTAATGGAAG
GGCATTTACCCCCCGCGAT -> GCATTTACCCCCCGCGATT
GGCCAGTGGACGTTTCTGG -> GCCAGTGGACGTTTCTGGG
GGCCATTCGGGTGCAAAGA -> GCCATTCGGGTGCAAAGAG
GGCCCATACCGGGACAAAC -> GCCCATACCGGGACAAACG
GGCCGCCTCCCATAGACGT -> GCCGCCTCCCATAGACGTC
GGCCGCGGTCTCAGGGTAC -> GCCGCGGTCTCAGGGTACG
GGCCGGCTTGGCCGCCTCC -> GCCGGCTTGGCCGCCTCCC
GGCGAAACCCTAAACCGCT -> GCGAAACCCTAAACCGCTC
GGCGACCGTGGTTTGGCAC -> GCGACCGTGGTTTGGCACA
GGCGAGAATGGGAATCCGG -> GCGAGAATGGGAATCCGGT
GGCGAGGTCATAATAGGGC -> GCGAGGTCATAATAGGGCT
GGCGCACAGTTATCATCGT -> GCGCACAGTTATCATCGTT
GGCGCCTCGTTCAAATCGG -> GCGCCTCGTTCAAATCGGG
GGCGCGATCATTTACTAGC -> GCGCGATCATTTACTAGCC
GGCGCGGTGAGAGGATCCG -> GCGCGGTGAGAGGATCCGG
GGCGTAATGGAAGCCAGAA -> GCGTAATGGAAGCCAGAAC
GGCGTGACAGTGTATATAA -> GCGTGACAGTGTATATAAC
GGCGTTCAGGAGTCTTGAG -> GCGTTCAGGAGTCTTGAGC
GGCGTTTCAGGCAATTACA -> GCGTTTCAGGCAATTACAA
GGCTAATTAGAAAAACTCT -> GCTAATTAGAAAAACTCTT
GGCTAGCTGGCAACGGACC -> GCTAGCTGGCAACGGACCC
GGCTAGTGGTAGCCTGGGT -> GCTAGTGGTAGCCTGGGTA
GGCTCAAATTAGAACTATA -> GCTCAAATTAGAACTATAA
GGCTCATTTTGAGTGGAAA -> GCTCATTTTGAGTGGAAAC
GGCTGCCATAAGCTTTTAC -> GCTGCCATAAGCTTTTACC
GGCTGGCGCACAGTTATCA -> GCTGGCGCACAGTTATCAT
GGCTTAGAGGCTTTCATGA -> GCTTAGAGGCTTTCATGAT
GGCTTGCGCACTGGCTCAT -> GCTTGCGCACTGGCTCATT
GGCTTGGCCGCCTCCCATA -> GCTTGGCCGCCTCCCATAG
GGCTTTCATGATTGCAGAG -> GCTTTCATGATTGCAGAGG
GGCTTTTAACAGGCCCATA -> GCTTTTAACAGGCCCATAC
GGGAAATACGGTGTTCTAC -> GGAAATACGGTGTTCTACA
GGGAATAACGCCTAAACTC -> GGAATAACGCCTAAACTCC
GGGAATCCGGTACGCGGGC -> GGAATCCGGTACGCGGGCA
GGGACAAACGGGCGACCGT -> GGACAAACGGGCGACCGTG
GGGACCTATTTACTAAGGT -> GGACCTATTTACTAAGGTC
GGGAGGCGTTTCAGGCAAT -> GGAGGCGTTTCAGGCAATT
GGGAGTTTGTGCACCTGCA -> GGAGTTTGTGCACCTGCAC
GGGATAGGGCAGTATCCCC -> GGATAGGGCAGTATCCCCG
GGGATGCGTGTCCCAGCAG -> GGATGCGTGTCCCAGCAGG
GGGATTCGTATCTCTATGT -> GGATTCGTATCTCTATGTG
GGGCAGTATCCCCGGCTAA -> GGCAGTATCCCCGGCTAAT
GGGCATCAATAATCCTCGG -> GGCATCAATAATCCTCGGT
GGGCCATTCGGGTGCAAAG -> GGCCATTCGGGTGCAAAGA
GGGCGAAACCCTAAACCGC -> GGCGAAACCCTAAACCGCT
GGGCGACCGTGGTTTGGCA -> GGCGACCGTGGTTTGGCAC
GGGCGAGGTCATAATAGGG -> GGCGAGGTCATAATAGGGC
GGGCGCGGTGAGAGGATCC -> GGCGCGGTGAGAGGATCCG
GGGCTCAAATTAGAACTAT -> GGCTCAAATTAGAACTATA
GGGCTGGCGCACAGTTATC -> GGCTGGCGCACAGTTATCA
GGGCTTAGAGGCTTTCATG -> GGCTTAGAGGCTTTCATGA
GGGCTTGCGCACTGGCTCA -> GGCTTGCGCACTGGCTCAT
GGGCTTTTAACAGGCCCAT -> GGCTTTTAACAGGCCCATA
GGGGAGGCGTTTCAGGCAA -> GGGAGGCGTTTCAGGCAAT
GGGGCCATTCGGGTGCAAA -> GGGCCATTCGGGTGCAAAG
GGGGTACATTCGGTTTATG -> GGGTACATTCGGTTTATGA
GGGGTAGCGCTTACCGTAA -> GGGTAGCGCTTACCGTAAA
GGGTAACCGTGAGCCCGCC -> GGTAACCGTGAGCCCGCCT
GGGTACATTCGGTTTATGA -> GGTACATTCGGTTTATGAG
GGGTACCTTTCGCGGTGAC -> GGTACCTTTCGCGGTGACC
GGGTACGTAAATCACACCT -> GGTACGTAAATCACACCTC
GGGTAGCGCTTACCGTAAA -> GGTAGCGCTTACCGTAAAC
GGGTATCTGTTTCAGACCC -> GGTATCTGTTTCAGACCCC
GGGTCGCTCGATGCTCGTA -> GGTCGCTCGATGCTCGTAA
GGGTCTGAGGAAGTTGTCT -> GGTCTGAGGAAGTTGTCTC
GGGTGCAAAGAGCCCACAC -> GGTGCAAAGAGCCCACACC
GGGTGGCGTTCAGGAGTCT -> GGTGGCGTTCAGGAGTCTT
GGGTGTCGCCAGTATTAGT -> GGTGTCGCCAGTATTAGTG
GGTAACCGTGAGCCCGCCT -> GTAACCGTGAGCCCGCCTA
GGTAATATTAAGTACCGGG -> GTAATATTAAGTACCGGGC
GGTAATGGGCGCGGTGAGA -> GTAATGGGCGCGGTGAGAG
GGTACATTCGGTTTATGAG -> GTACATTCGGTTTATGAGA
GGTACCTTTCGCGGTGACC -> GTACCTTTCGCGGTGACCG
GGTACGCGAGGCGTGACAG -> GTACGCGAGGCGTGACAGT
GGTACGCGGGCATCAATAA -> GTACGCGGGCATCAATAAT
GGTACGTAAATCACACCTC -> GTACGTAAATCACACCTCT
GGTAGCCTGGGTATCTGTT -> GTAGCCTGGGTATCTGTTT
GGTAGCGCTTACCGTAAAC -> GTAGCGCTTACCGTAAACT
GGTATCTGTTTCAGACCCC -> GTATCTGTTTCAGACCCCC
GGTCACCATACCCAGGGTA -> GTCACCATACCCAGGGTAC
GGTCACGCTATGCGCTCGG -> GTCACGCTATGCGCTCGGG
GGTCATAATAGGGCTTGCG -> GTCATAATAGGGCTTGCGC
GGTCCAGCCCCGGTTGGCG -> GTCCAGCCCCGGTTGGCGC
GGTCCGCCGAGTCGCTTTT -> GTCCGCCGAGTCGCTTTTC
GGTCGCGACACCTGTCGGG -> GTCGCGACACCTGTCGGGA
GGTCGCTCGATGCTCGTAA -> GTCGCTCGATGCTCGTAAG
GGTCTCAGGGTACGTAAAT -> GTCTCAGGGTACGTAAATC
GGTCTGAGGAAGTTGTCTC -> GTCTGAGGAAGTTGTCTCG
GGTCTGCGTAGGTCCAGCC -> GTCTGCGTAGGTCCAGCCC
GGTGACCGCGACCCTTAAT -> GTGACCGCGACCCTTAATA
GGTGAGAAAACTCTTAGGG -> GTGAGAAAACTCTTAGGGG
GGTGAGAGGATCCGGACTT -> GTGAGAGGATCCGGACTTT
GGTGCAAAGAGCCCACACC -> GTGCAAAGAGCCCACACCG
GGTGCGGCTAGCTGGCAAC -> GTGCGGCTAGCTGGCAACG
GGTGGCGTTCAGGAGTCTT -> GTGGCGTTCAGGAGTCTTG
GGTGTACTGCGTACGTGGG -> GTGTACTGCGTACGTGGGG
GGTGTCGCCAGTATTAGTG -> GTGTCGCCAGTATTAGTGT
GGTGTGTAAATTTGACACT -> GTGTGTAAATTTGACACTT
GGTGTTCTACACGAAGTAA -> GTGTTCTACACGAAGTAAG
GGTTAGACATCGCGTTCCA -> GTTAGACATCGCGTTCCAT
GGTTAGACGCATCCCGTAT -> GTTAGACGCATCCCGTATC
GGTTAGGTGTACTGCGTAC -> GTTAGGTGTACTGCGTACG
GGTTGATACCCCGTTGTGC -> GTTGATACCCCGTTGTGCG
GGTTGGCGCGATCATTTAC -> GTTGGCGCGATCATTTACT
GGTTTATGAGAGGGTCTGA -> GTTTATGAGAGGGTCTGAG
GGTTTGGCACATTAAGTTA -> GTTTGGCACATTAAGTTAA
GGTTTTGTTAAGACTAACG -> GTTTTGTTAAGACTAACGA
GTAAACTCTGTTGTGCAGG -> TAAACTCTGTTGTGCAGGA
GTAAAGATCGCGATATGGT -> TAAAGATCGCGATATGGTG
GTAAATCACACCTCTCAAC -> TAAATCACACCTCTCAACA
GTAAATTTGACACTTTCGG -> TAAATTTGACACTTTCGGC
GTAACCAAGGCATGAGGCG -> TAACCAAGGCATGAGGCGT
GTAACCGTGAGCCCGCCTA -> TAACCGTGAGCCCGCCTAC
GTAAGAAGCGAAGTTTAGA -> TAAGAAGCGAAGTTTAGAC
GTAAGAGTCAGCTACTTGG -> TAAGAGTCAGCTACTTGGG
GTAAGTCGCTGACCGATGT -> TAAGTCGCTGACCGATGTT
GTAATATTAAGTACCGGGC -> TAATATTAAGTACCGGGCT
GTAATGCTTGACCGGTGCG -> TAATGCTTGACCGGTGCGG
GTAATGGAAGCCAGAACCG -> TAATGGAAGCCAGAACCGT
GTAATGGGCGCGGTGAGAG -> TAATGGGCGCGGTGAGAGG
GTAATTTGCGCACACATAC -> TAATTTGCGCACACATACT
GTACATTCGGTTTATGAGA -> TACATTCGGTTTATGAGAG
GTACCGGGCTCAAATTAGA -> TACCGGGCTCAAATTAGAA
GTACCTTTCGCGGTGACCG -> TACCTTTCGCGGTGACCGC
GTACGCGAGGCGTGACAGT -> TACGCGAGGCGTGACAGTG
GTACGCGGGCATCAATAAT -> TACGCGGGCATCAATAATC
GTACGCTGAGTCAAAGCGA -> TACGCTGAGTCAAAGCGAA
GTACGTAAATCACACCTCT -> TACGTAAATCACACCTCTC
GTACGTGGGGAGGCGTTTC -> TACGTGGGGAGGCGTTTCA
GTACTAAGCGTGATCTAGA -> TACTAAGCGTGATCTAGAT
GTACTGCGTACGTGGGGAG -> TACTGCGTACGTGGGGAGG
GTAGATGATTCGGATTGTG -> TAGATGATTCGGATTGTGG
GTAGCCTGGGTATCTGTTT -> TAGCCTGGGTATCTGTTTC
GTAGCGCTTACCGTAAACT -> TAGCGCTTACCGTAAACTC
GTAGGAAGAAATCAATACA -> TAGGAAGAAATCAATACAG
GTAGGATATTTTAGGACCC -> TAGGATATTTTAGGACCCC
GTAGGTCCAGCCCCGGTTG -> TAGGTCCAGCCCCGGTTGG
GTAGTATTACCTGGTGAGA -> TAGTATTACCTGGTGAGAA
GTAGTCCCTAAACCGCTCG -> TAGTCCCTAAACCGCTCGC
GTATAACCTTAAGACGGTT -> TATAACCTTAAGACGGTTT
GTATATAACGGACCGCTGG -> TATATAACGGACCGCTGGT
GTATCCCCGGCTAATTAGA -> TATCCCCGGCTAATTAGAA
GTATCCGGGGCCATTCGGG -> TATCCGGGGCCATTCGGGT
GTATCTCTATGTGAGGTCG -> TATCTCTATGTGAGGTCGC
GTATCTGTTTCAGACCCCC -> TATCTGTTTCAGACCCCCA
GTATTACCTGGTGAGAAAA -> TATTACCTGGTGAGAAAAC
GTATTAGTGTCAGGTCACC -> TATTAGTGTCAGGTCACCA
GTATTTAATCTCCATTTCT -> TATTTAATCTCCATTTCTG
GTCAAAGCGAATGATGGTC -> TCAAAGCGAATGATGGTCT
GTCACACAGGGTGTCGCCA -> TCACACAGGGTGTCGCCAG
GTCACCATACCCAGGGTAC -> TCACCATACCCAGGGTACC
GTCACGCTATGCGCTCGGG -> TCACGCTATGCGCTCGGGC
GTCAGCTACTTGGGCTTTT -> TCAGCTACTTGGGCTTTTA
GTCAGGTCACCATACCCAG -> TCAGGTCACCATACCCAGG
GTCATAATAGGGCTTGCGC -> TCATAATAGGGCTTGCGCA
GTCATTTAAGTAGGAAGAA -> TCATTTAAGTAGGAAGAAA
GTCCAGCCCCGGTTGGCGC -> TCCAGCCCCGGTTGGCGCG
GTCCCAGCAGGGCGAGGTC -> TCCCAGCAGGGCGAGGTCA
GTCCCTAAACCGCTCGCAG -> TCCCTAAACCGCTCGCAGA,TCCCTAAACCGCTCGCAGA
GTCCGCCGAGTCGCTTTTC -> TCCGCCGAGTCGCTTTTCG
GTCCTTTCCAACGCCATTG -> TCCTTTCCAACGCCATTGA
GTCGCCAGTATTAGTGTCA -> TCGCCAGTATTAGTGTCAG
GTCGCGACACCTGTCGGGA -> TCGCGACACCTGTCGGGAG
GTCGCTCGATGCTCGTAAG -> TCGCTCGATGCTCGTAAGA
GTCGCTGACCGATGTTCAG -> TCGCTGACCGATGTTCAGA
GTCGCTTTTCGCAGGGAAT -> TCGCTTTTCGCAGGGAATA
GTCGGGAGTTTGTGCACCT -> TCGGGAGTTTGTGCACCTG
GTCTACGTTAGGCATTTAC -> TCTACGTTAGGCATTTACC
GTCTCACCCGCCGGTTAGA -> TCTCACCCGCCGGTTAGAC
GTCTCAGGGTACGTAAATC -> TCTCAGGGTACGTAAATCA
GTCTCCTTACGATATTGTT -> TCTCCTTACGATATTGTTA
GTCTCGGAGAAATCAATAC -> TCTCGGAGAAATCAATACA
GTCTGAGGAAGTTGTCTCG -> TCTGAGGAAGTTGTCTCGG
GTCTGCGGATCCCCCACAA -> TCTGCGGATCCCCCACAAG
GTCTGCGTAGGTCCAGCCC -> TCTGCGTAGGTCCAGCCCC
GTCTTGAGCGTGCTAAAGC -> TCTTGAGCGTGCTAAAGCC
GTGACAGTGTATATAACGG -> TGACAGTGTATATAACGGA
GTGACCGCGACCCTTAATA -> TGACCGCGACCCTTAATAG
GTGAGAAAACTCTTAGGGG -> TGAGAAAACTCTTAGGGGT
GTGAGAGGATCCGGACTTT -> TGAGAGGATCCGGACTTTG
GTGAGCCCGCCTACGCCCA -> TGAGCCCGCCTACGCCCAT
GTGAGGAATGCGAACAAAC -> TGAGGAATGCGAACAAACA
GTGAGGTCGCGACACCTGT -> TGAGGTCGCGACACCTGTC
GTGATCGTAACCAAGGCAT -> TGATCGTAACCAAGGCATG
GTGATCTAGATAGTTTTAA -> TGATCTAGATAGTTTTAAG
GTGATGTAGTCCCTAAACC -> TGATGTAGTCCCTAAACCG
GTGCAAAGAGCCCACACCG -> TGCAAAGAGCCCACACCGG
GTGCACCTGCACGTGTCAT -> TGCACCTGCACGTGTCATT
GTGCAGGATAAGCTTCCTG -> TGCAGGATAAGCTTCCTGT
GTGCATCATCTGTACGCTG -> TGCATCATCTGTACGCTGA
GTGCGCCAACTCTTCGGGA -> TGCGCCAACTCTTCGGGAC
GTGCGGCTAGCTGGCAACG -> TGCGGCTAGCTGGCAACGG
GTGCTAAAGCCTTTAGAGG -> TGCTAAAGCCTTTAGAGGT
GTGGAAACCGCAGAGTTCG -> TGGAAACCGCAGAGTTCGA
GTGGAACCGTATAACCTTA -> TGGAACCGTATAACCTTAA
GTGGACGTTTCTGGGGTAG -> TGGACGTTTCTGGGGTAGC
GTGGATCGAGAGAGAACTT -> TGGATCGAGAGAGAACTTC
GTGGCGTTCAGGAGTCTTG -> TGGCGTTCAGGAGTCTTGA
GTGGGGAGGCGTTTCAGGC -> TGGGGAGGCGTTTCAGGCA
GTGGTAGCCTGGGTATCTG -> TGGTAGCCTGGGTATCTGT
GTGGTTAGACGCATCCCGT -> TGGTTAGACGCATCCCGTA
GTGGTTTGGCACATTAAGT -> TGGTTTGGCACATTAAGTT
GTGTAAATTTGACACTTTC -> TGTAAATTTGACACTTTCG
GTGTACTGCGTACGTGGGG -> TGTACTGCGTACGTGGGGA
GTGTAGTATTACCTGGTGA -> TGTAGTATTACCTGGTGAG
GTGTATATAACGGACCGCT -> TGTATATAACGGACCGCTG
GTGTCACACAGGGTGTCGC -> TGTCACACAGGGTGTCGCC
GTGTCAGGTCACCATACCC -> TGTCAGGTCACCATACCCA
GTGTCATTTAAGTAGGAAG -> TGTCATTTAAGTAGGAAGA
GTGTCCCAGCAGGGCGAGG -> TGTCCCAGCAGGGCGAGGT
GTGTCGCCAGTATTAGTGT -> TGTCGCCAGTATTAGTGTC
GTGTCTACGTTAGGCATTT -> TGTCTACGTTAGGCATTTA
GTGTGTAAATTTGACACTT -> TGTGTAAATTTGACACTTT
GTGTTCTACACGAAGTAAG -> TGTTCTACACGAAGTAAGT
GTTAACCTTCCAGGACACC -> TTAACCTTCCAGGACACCA
GTTAAGACTAACGAGTTAC -> TTAAGACTAACGAGTTACC
GTTACCCATATTAGAAGTG -> TTACCCATATTAGAAGTGC
GTTAGAAATCAATACAGCA -> TTAGAAATCAATACAGCAA
GTTAGACATCGCGTTCCAT -> TTAGACATCGCGTTCCATA
GTTAGACGCATCCCGTATC -> TTAGACGCATCCCGTATCC
GTTAGGCATTTACCCCCCG -> TTAGGCATTTACCCCCCGC
GTTAGGTGTACTGCGTACG -> TTAGGTGTACTGCGTACGT
GTTATCATCGTTATCTCCA -> TTATCATCGTTATCTCCAA
GTTATCTCCAATCGGCGAG -> TTATCTCCAATCGGCGAGA
GTTCAAATCGGGAAATACG -> TTCAAATCGGGAAATACGG
GTTCAGAAATCAATACAGC -> TTCAGAAATCAATACAGCA
GTTCAGGAGTCTTGAGCGT -> TTCAGGAGTCTTGAGCGTG
GTTCCATAATGCGTATTTA -> TTCCATAATGCGTATTTAA
GTTCCTAAGTCTCACCCGC -> TTCCTAAGTCTCACCCGCC
GTTCGAGCGCTCAATAGCG -> TTCGAGCGCTCAATAGCGG
GTTCGGCTAGTGGTAGCCT -> TTCGGCTAGTGGTAGCCTG
GTTCTACACGAAGTAAGTC -> TTCTACACGAAGTAAGTCG
GTTGATACCCCGTTGTGCG -> TTGATACCCCGTTGTGCGC
GTTGGCCGGCTTGGCCGCC -> TTGGCCGGCTTGGCCGCCT
GTTGGCGCGATCATTTACT -> TTGGCGCGATCATTTACTA
GTTGGGATGCGTGTCCCAG -> TTGGGATGCGTGTCCCAGC
GTTGTCTCGGAGAAATCAA -> TTGTCTCGGAGAAATCAAT
GTTGTGCAGGATAAGCTTC -> TTGTGCAGGATAAGCTTCC
GTTGTGCGCCAACTCTTCG -> TTGTGCGCCAACTCTTCGG
GTTTAGACTCTCATTGAAG -> TTTAGACTCTCATTGAAGT
GTTTATGAGAGGGTCTGAG -> TTTATGAGAGGGTCTGAGG
GTTTCAGACCCCCACTTCG -> TTTCAGACCCCCACTTCGG
GTTTCAGGCAATTACAAAT -> TTTCAGGCAATTACAAATG
GTTTCTGGGGTAGCGCTTA -> TTTCTGGGGTAGCGCTTAC
GTTTGGCACATTAAGTTAA -> TTTGGCACATTAAGTTAAC
GTTTGTGCACCTGCACGTG -> TTTGTGCACCTGCACGTGT
GTTTTAAGGAGTGGAACCG -> TTTTAAGGAGTGGAACCGT
GTTTTGTTAAGACTAACGA -> TTTTGTTAAGACTAACGAG
TAAACCGCTCGCAGAATAA -> AAACCGCTCGCAGAATAAG
TAAACCGCTCGCAGAATCA -> AAACCGCTCGCAGAATCAG
TAAACCGCTCGCAGAATTA -> AAACCGCTCGCAGAATTAT
TAAACCGCTCGCAGAATTG -> AAACCGCTCGCAGAATTGT
TAAACTCCATTCTGAGCGA -> AAACTCCATTCTGAGCGAC
TAAACTCTGTTGTGCAGGA -> AAACTCTGTTGTGCAGGAT
TAAAGATCGCGATATGGTG -> AAAGATCGCGATATGGTGT
TAAAGCCTTTAGAGGTACG -> AAAGCCTTTAGAGGTACGC
TAAATCACACCTCTCAACA -> AAATCACACCTCTCAACAA
TAAATTTGACACTTTCGGC -> AAATTTGACACTTTCGGCC
TAACAGCTGGCCAGTGGAC -> AACAGCTGGCCAGTGGACG
TAACAGGCCCATACCGGGA -> AACAGGCCCATACCGGGAC
TAACCAAGGCATGAGGCGT -> AACCAAGGCATGAGGCGTA
TAACCGTGAGCCCGCCTAC -> AACCGTGAGCCCGCCTACG
TAACCTTAAGACGGTTTTG -> AACCTTAAGACGGTTTTGT
TAACCTTCCAGGACACCAG -> AACCTTCCAGGACACCAGA
TAACGAGTTACCCATATTA -> AACGAGTTACCCATATTAG
TAACGCCTAAACTCCATTC -> AACGCCTAAACTCCATTCT
TAACGGACCGCTGGTTGAT -> AACGGACCGCTGGTTGATA
TAAGAAGCGAAGTTTAGAC -> AAGAAGCGAAGTTTAGACT
TAAGACGGTTTTGTTAAGA -> AAGACGGTTTTGTTAAGAC
TAAGACTAACGAGTTACCC -> AAGACTAACGAGTTACCCA
TAAGAGTCAGCTACTTGGG -> AAGAGTCAGCTACTTGGGC
TAAGCCTGCGACCGTAATT -> AAGCCTGCGACCGTAATTT
TAAGCGTGATCTAGATAGT -> AAGCGTGATCTAGATAGTT
TAAGCTTAACAGCTGGCCA -> AAGCTTAACAGCTGGCCAG
TAAGCTTCCTGTGGTTAGA -> AAGCTTCCTGTGGTTAGAC
TAAGCTTTTACCCTAGGAA -> AAGCTTTTACCCTAGGAAT
TAAGGAGTGGAACCGTATA -> AAGGAGTGGAACCGTATAA
TAAGGTCACGCTATGCGCT -> AAGGTCACGCTATGCGCTC
TAAGTACCGGGCTCAAATT -> AAGTACCGGGCTCAAATTA
TAAGTAGGAAGAAATCAAT -> AAGTAGGAAGAAATCAATA
TAAGTCGCTGACCGATGTT -> AAGTCGCTGACCGATGTTC
TAAGTCTCACCCGCCGGTT -> AAGTCTCACCCGCCGGTTA
TAAGTTAACCTTCCAGGAC -> AAGTTAACCTTCCAGGACA
TAATAGGGCTTGCGCACTG -> AATAGGGCTTGCGCACTGG
TAATAGTAAGAGTCAGCTA -> AATAGTAAGAGTCAGCTAC
TAATATTAAGTACCGGGCT -> AATATTAAGTACCGGGCTC
TAATCCTCGGTAATATTAA -> AATCCTCGGTAATATTAAG
TAATCTATGTGTCACACAG -> AATCTATGTGTCACACAGG
TAATCTCCATTTCTGGTAA -> AATCTCCATTTCTGGTAAT
TAATGAGGATGAGCCATAT -> AATGAGGATGAGCCATATA
TAATGCGTATTTAATCTCC -> AATGCGTATTTAATCTCCA
TAATGCTTGACCGGTGCGG -> AATGCTTGACCGGTGCGGC
TAATGGAAGCCAGAACCGT -> AATGGAAGCCAGAACCGTT
TAATGGGCGCGGTGAGAGG -> AATGGGCGCGGTGAGAGGA
TAATTAGAAAAACTCTTAG -> AATTAGAAAAACTCTTAGT
TAATTTGCGCACACATACT -> AATTTGCGCACACATACTT
TACACGAAGTAAGTCGCTG -> ACACGAAGTAAGTCGCTGA
TACAGAGTCCCTAAACCGC -> ACAGAGTCCCTAAACCGCT
TACAGCAACAAAGACCCGC -> ACAGCAACAAAGACCCGCA
TACAGCAACCTGGGCGAAA -> ACAGCAACCTGGGCGAAAC
TACAGCAACGTGATGTAGT -> ACAGCAACGTGATGTAGTC
TACAGCAACTCTACAGAGT -> ACAGCAACTCTACAGAGTC
TACATTCGGTTTATGAGAG -> ACATTCGGTTTATGAGAGG
TACCCAGGGTACCTTTCGC -> ACCCAGGGTACCTTTCGCG
TACCCATATTAGAAGTGCA -> ACCCATATTAGAAGTGCAT
TACCCCCCGCGATTTGACT -> ACCCCCCGCGATTTGACTA
TACCCCGTTGTGCGCCAAC -> ACCCCGTTGTGCGCCAACT
TACCCTAGGAATTAGTGTC -> ACCCTAGGAATTAGTGTCT
TACCGGGACAAACGGGCGA -> ACCGGGACAAACGGGCGAC
TACCGGGCTCAAATTAGAA -> ACCGGGCTCAAATTAGAAC
TACCGTAAACTCTGTTGTG -> ACCGTAAACTCTGTTGTGC
TACCTGGTGAGAAAACTCT -> ACCTGGTGAGAAAACTCTT
TACCTTTCGCGGTGACCGC -> ACCTTTCGCGGTGACCGCG
TACGATATTGTTAGAAATC -> ACGATATTGTTAGAAATCA
TACGCCCATGTTCCTAAGT -> ACGCCCATGTTCCTAAGTC
TACGCGAGGCGTGACAGTG -> ACGCGAGGCGTGACAGTGT
TACGCGGGCATCAATAATC -> ACGCGGGCATCAATAATCC
TACGCTGAGTCAAAGCGAA -> ACGCTGAGTCAAAGCGAAT
TACGGTGTTCTACACGAAG -> ACGGTGTTCTACACGAAGT
TACGTAAATCACACCTCTC -> ACGTAAATCACACCTCTCA
TACGTGGGGAGGCGTTTCA -> ACGTGGGGAGGCGTTTCAG
TACGTTAGGCATTTACCCC -> ACGTTAGGCATTTACCCCC
TACTAAGCGTGATCTAGAT -> ACTAAGCGTGATCTAGATA
TACTAAGGTCACGCTATGC -> ACTAAGGTCACGCTATGCG
TACTAGCCCCGGGTAACCG -> ACTAGCCCCGGGTAACCGT
TACTGCGTACGTGGGGAGG -> ACTGCGTACGTGGGGAGGC
TACTTGCACTAGCGTCTCC -> ACTTGCACTAGCGTCTCCT
TACTTGGGCTTTTAACAGG -> ACTTGGGCTTTTAACAGGC
TAGAAAAACTCTTAGTGTA -> AGAAAAACTCTTAGTGTAG
TAGAAATCAATACAGCAAC -> AGAAATCAATACAGCAACT
TAGAACTATAATCTATGTG -> AGAACTATAATCTATGTGT
TAGAAGTGCATCATCTGTA -> AGAAGTGCATCATCTGTAC
TAGACATCGCGTTCCATAA -> AGACATCGCGTTCCATAAT
TAGACGCATCCCGTATCCG -> AGACGCATCCCGTATCCGG
TAGACGTCTGCGGATCCCC -> AGACGTCTGCGGATCCCCC
TAGACTCTCATTGAAGTTG -> AGACTCTCATTGAAGTTGG
TAGAGGCTTTCATGATTGC -> AGAGGCTTTCATGATTGCA
TAGAGGTACGCGAGGCGTG -> AGAGGTACGCGAGGCGTGA
TAGATAGTTTTAAGGAGTG -> AGATAGTTTTAAGGAGTGG
TAGATGATTCGGATTGTGG -> AGATGATTCGGATTGTGGA
TAGCCCCGGGTAACCGTGA -> AGCCCCGGGTAACCGTGAG
TAGCCTGGGTATCTGTTTC -> AGCCTGGGTATCTGTTTCA
TAGCGCTTACCGTAAACTC -> AGCGCTTACCGTAAACTCT
TAGCGGCGCCTCGTTCAAA -> AGCGGCGCCTCGTTCAAAT
TAGCGTCTCCTTACGATAT -> AGCGTCTCCTTACGATATT
TAGCTGGCAACGGACCCAA -> AGCTGGCAACGGACCCAAA
TAGGAAGAAATCAATACAG -> AGGAAGAAATCAATACAGC
TAGGAATTAGTGTCTACGT -> AGGAATTAGTGTCTACGTT
TAGGACCCCCGCGCGATAT -> AGGACCCCCGCGCGATATA
TAGGATATTTTAGGACCCC -> AGGATATTTTAGGACCCCC
TAGGCATTTACCCCCCGCG -> AGGCATTTACCCCCCGCGA
TAGGGCAGTATCCCCGGCT -> AGGGCAGTATCCCCGGCTA
TAGGGCTTGCGCACTGGCT -> AGGGCTTGCGCACTGGCTC
TAGGGGTACATTCGGTTTA -> AGGGGTACATTCGGTTTAT
TAGGTCCAGCCCCGGTTGG -> AGGTCCAGCCCCGGTTGGC
TAGGTGTACTGCGTACGTG -> AGGTGTACTGCGTACGTGG
TAGTAAGAGTCAGCTACTT -> AGTAAGAGTCAGCTACTTG
TAGTATTACCTGGTGAGAA -> AGTATTACCTGGTGAGAAA
TAGTCCCTAAACCGCTCGC -> AGTCCCTAAACCGCTCGCA
TAGTGATCGTAACCAAGGC -> AGTGATCGTAACCAAGGCA
TAGTGGTAGCCTGGGTATC -> AGTGGTAGCCTGGGTATCT
TAGTGTAGTATTACCTGGT -> AGTGTAGTATTACCTGGTG
TAGTGTCAGGTCACCATAC -> AGTGTCAGGTCACCATACC
TAGTGTCTACGTTAGGCAT -> AGTGTCTACGTTAGGCATT
TAGTTTTAAGGAGTGGAAC -> AGTTTTAAGGAGTGGAACC
TATAACCTTAAGACGGTTT -> ATAACCTTAAGACGGTTTT
TATAACGGACCGCTGGTTG -> ATAACGGACCGCTGGTTGA
TATAAGCTTAACAGCTGGC -> ATAAGCTTAACAGCTGGCC
TATAATCTATGTGTCACAC -> ATAATCTATGTGTCACACA
TATATAACGGACCGCTGGT -> ATATAACGGACCGCTGGTT
TATATTCAACCGATGAAGG -> ATATTCAACCGATGAAGGG
TATCATCGTTATCTCCAAT -> ATCATCGTTATCTCCAATC
TATCCCCGGCTAATTAGAA -> ATCCCCGGCTAATTAGAAA
TATCCGGGGCCATTCGGGT -> ATCCGGGGCCATTCGGGTG
TATCTCCAATCGGCGAGAA -> ATCTCCAATCGGCGAGAAT
TATCTCTATGTGAGGTCGC -> ATCTCTATGTGAGGTCGCG
TATCTGGGCTTAGAGGCTT -> ATCTGGGCTTAGAGGCTTT
TATCTGTTTCAGACCCCCA -> ATCTGTTTCAGACCCCCAC
TATGAGAGGGTCTGAGGAA -> ATGAGAGGGTCTGAGGAAG
TATGCGCTCGGGCTGGCGC -> ATGCGCTCGGGCTGGCGCA
TATGGTGTGTAAATTTGAC -> ATGGTGTGTAAATTTGACA
TATGTGAGGTCGCGACACC -> ATGTGAGGTCGCGACACCT
TATGTGTCACACAGGGTGT -> ATGTGTCACACAGGGTGTC
TATTAAGTACCGGGCTCAA -> ATTAAGTACCGGGCTCAAA
TATTACCTGGTGAGAAAAC -> ATTACCTGGTGAGAAAACT
TATTAGAAGTGCATCATCT -> ATTAGAAGTGCATCATCTG
TATTAGTGTCAGGTCACCA -> ATTAGTGTCAGGTCACCAT
TATTCAACCGATGAAGGGT -> ATTCAACCGATGAAGGGTG
TATTGGTCCGCCGAGTCGC -> ATTGGTCCGCCGAGTCGCT
TATTGTTAGAAATCAATAC -> ATTGTTAGAAATCAATACA
TATTTAATCTCCATTTCTG -> ATTTAATCTCCATTTCTGG
TATTTACTAAGGTCACGCT -> ATTTACTAAGGTCACGCTA
TATTTTAGGACCCCCGCGC -> ATTTTAGGACCCCCGCGCG
TCAAAGCGAATGATGGTCT -> CAAAGCGAATGATGGTCTG
TCAAATCGGGAAATACGGT -> CAAATCGGGAAATACGGTG
TCAAATTAGAACTATAATC -> CAAATTAGAACTATAATCT
TCAACAAGTGAGGAATGCG -> CAACAAGTGAGGAATGCGA
TCAACCGATGAAGGGTGGC -> CAACCGATGAAGGGTGGCG
TCAAGAGTAAAGATCGCGA -> CAAGAGTAAAGATCGCGAT
TCAATAATCCTCGGTAATA -> CAATAATCCTCGGTAATAT
TCAATACAGCAACAAAGAC -> CAATACAGCAACAAAGACC
TCAATACAGCAACCTGGGC -> CAATACAGCAACCTGGGCG
TCAATACAGCAACGTGATG -> CAATACAGCAACGTGATGT
TCAATACAGCAACTCTACA -> CAATACAGCAACTCTACAG
TCAATAGCGGCGCCTCGTT -> CAATAGCGGCGCCTCGTTC
TCAATAGTGATCGTAACCA -> CAATAGTGATCGTAACCAA
TCACACAGGGTGTCGCCAG -> CACACAGGGTGTCGCCAGT
TCACACCTCTCAACAAGTG -> CACACCTCTCAACAAGTGA
TCACCATACCCAGGGTACC -> CACCATACCCAGGGTACCT
TCACCCGCCGGTTAGACAT -> CACCCGCCGGTTAGACATC
TCACGCTATGCGCTCGGGC -> CACGCTATGCGCTCGGGCT
TCAGAAATCAATACAGCAA -> CAGAAATCAATACAGCAAC
TCAGACCCCCACTTCGGGT -> CAGACCCCCACTTCGGGTC
TCAGCGAAACAGCCGAAGG -> CAGCGAAACAGCCGAAGGA
TCAGCTACTTGGGCTTTTA -> CAGCTACTTGGGCTTTTAA
TCAGGAGTCTTGAGCGTGC -> CAGGAGTCTTGAGCGTGCT
TCAGGCAATTACAAATGTG -> CAGGCAATTACAAATGTGT
TCAGGGATAGGGCAGTATC -> CAGGGATAGGGCAGTATCC
TCAGGGTACGTAAATCACA -> CAGGGTACGTAAATCACAC
TCAGGTCACCATACCCAGG -> CAGGTCACCATACCCAGGG
TCATAATAGGGCTTGCGCA -> CATAATAGGGCTTGCGCAC
TCATCGTTATCTCCAATCG -> CATCGTTATCTCCAATCGG
TCATCTGTACGCTGAGTCA -> CATCTGTACGCTGAGTCAA
TCATGATTGCAGAGGACTA -> CATGATTGCAGAGGACTAT
TCATTGAAGTTGGGATGCG -> CATTGAAGTTGGGATGCGT
TCATTTAAGTAGGAAGAAA -> CATTTAAGTAGGAAGAAAT
TCATTTACTAGCCCCGGGT -> CATTTACTAGCCCCGGGTA
TCATTTTGAGTGGAAACCG -> CATTTTGAGTGGAAACCGC
TCCAACGCCATTGACGACC -> CCAACGCCATTGACGACCT
TCCAATCGGCGAGAATGGG -> CCAATCGGCGAGAATGGGA
TCCAGCCCCGGTTGGCGCG -> CCAGCCCCGGTTGGCGCGA
TCCAGGACACCAGATGCGA -> CCAGGACACCAGATGCGAG
TCCATAATGCGTATTTAAT -> CCATAATGCGTATTTAATC
TCCATTCTGAGCGACGCAT -> CCATTCTGAGCGACGCATT
TCCATTTCTGGTAATGGGC -> CCATTTCTGGTAATGGGCG
TCCCAGCAGGGCGAGGTCA -> CCCAGCAGGGCGAGGTCAT
TCCCATAGACGTCTGCGGA -> CCCATAGACGTCTGCGGAT
TCCCCCACAAGATTTCAAT -> CCCCCACAAGATTTCAATA
TCCCCGGCTAATTAGAAAA -> CCCCGGCTAATTAGAAAAA
TCCCGTATCCGGGGCCATT -> CCCGTATCCGGGGCCATTC
TCCCTAAACCGCTCGCAGA -> CCCTAAACCGCTCGCAGAA,CCCTAAACCGCTCGCAGAA
TCCGCCGAGTCGCTTTTCG -> CCGCCGAGTCGCTTTTCGC
TCCGGACTTTGTAGGATAT -> CCGGACTTTGTAGGATATT
TCCGGGGCCATTCGGGTGC -> CCGGGGCCATTCGGGTGCA
TCCGGTACGCGGGCATCAA -> CCGGTACGCGGGCATCAAT
TCCGTCCTTTCCAACGCCA -> CCGTCCTTTCCAACGCCAT
TCCTAAGTCTCACCCGCCG -> CCTAAGTCTCACCCGCCGG
TCCTCGGTAATATTAAGTA -> CCTCGGTAATATTAAGTAC
TCCTGTGGTTAGACGCATC -> CCTGTGGTTAGACGCATCC
TCCTTACGATATTGTTAGA -> CCTTACGATATTGTTAGAA
TCCTTTCCAACGCCATTGA -> CCTTTCCAACGCCATTGAC
TCGAGAGAGAACTTCAGCG -> CGAGAGAGAACTTCAGCGA
TCGAGCGCTCAATAGCGGC -> CGAGCGCTCAATAGCGGCG
TCGATGCTCGTAAGAAGCG -> CGATGCTCGTAAGAAGCGA
TCGCAGAATAAGCCTGCGA -> CGCAGAATAAGCCTGCGAC
TCGCAGAATCAGGGATAGG -> CGCAGAATCAGGGATAGGG
TCGCAGAATTATCTGGGCT -> CGCAGAATTATCTGGGCTT
TCGCAGAATTGTACTAAGC -> CGCAGAATTGTACTAAGCG
TCGCAGGGAATAACGCCTA -> CGCAGGGAATAACGCCTAA
TCGCCAGTATTAGTGTCAG -> CGCCAGTATTAGTGTCAGG
TCGCGACACCTGTCGGGAG -> CGCGACACCTGTCGGGAGT
TCGCGATATGGTGTGTAAA -> CGCGATATGGTGTGTAAAT
TCGCGGTGACCGCGACCCT -> CGCGGTGACCGCGACCCTT
TCGCGTTCCATAATGCGTA -> CGCGTTCCATAATGCGTAT
TCGCTCGATGCTCGTAAGA -> CGCTCGATGCTCGTAAGAA
TCGCTGACCGATGTTCAGA -> CGCTGACCGATGTTCAGAA
TCGCTTTTCGCAGGGAATA -> CGCTTTTCGCAGGGAATAA
TCGGAGAAATCAATACAGC -> CGGAGAAATCAATACAGCA
TCGGATTGTGGATCGAGAG -> CGGATTGTGGATCGAGAGA
TCGGCCGCGGTCTCAGGGT -> CGGCCGCGGTCTCAGGGTA
TCGGCGAGAATGGGAATCC -> CGGCGAGAATGGGAATCCG
TCGGCTAGTGGTAGCCTGG -> CGGCTAGTGGTAGCCTGGG
TCGGGAAATACGGTGTTCT -> CGGGAAATACGGTGTTCTA
TCGGGACCTATTTACTAAG -> CGGGACCTATTTACTAAGG
TCGGGAGTTTGTGCACCTG -> CGGGAGTTTGTGCACCTGC
TCGGGCTGGCGCACAGTTA -> CGGGCTGGCGCACAGTTAT
TCGGGTCGCTCGATGCTCG -> CGGGTCGCTCGATGCTCGT
TCGGGTGCAAAGAGCCCAC -> CGGGTGCAAAGAGCCCACA
TCGGTAATATTAAGTACCG -> CGGTAATATTAAGTACCGG
TCGGTTTATGAGAGGGTCT -> CGGTTTATGAGAGGGTCTG
TCGTAACCAAGGCATGAGG -> CGTAACCAAGGCATGAGGC
TCGTAAGAAGCGAAGTTTA -> CGTAAGAAGCGAAGTTTAG
TCGTATCTCTATGTGAGGT -> CGTATCTCTATGTGAGGTC
TCGTTATCTCCAATCGGCG -> CGTTATCTCCAATCGGCGA
TCGTTCAAATCGGGAAATA -> CGTTCAAATCGGGAAATAC
TCTACACGAAGTAAGTCGC -> CTACACGAAGTAAGTCGCT
TCTACAGAGTCCCTAAACC -> CTACAGAGTCCCTAAACCG
TCTACGTTAGGCATTTACC -> CTACGTTAGGCATTTACCC
TCTAGATAGTTTTAAGGAG -> CTAGATAGTTTTAAGGAGT
TCTATGTGAGGTCGCGACA -> CTATGTGAGGTCGCGACAC
TCTATGTGTCACACAGGGT -> CTATGTGTCACACAGGGTG
TCTCAACAAGTGAGGAATG -> CTCAACAAGTGAGGAATGC
TCTCACCCGCCGGTTAGAC -> CTCACCCGCCGGTTAGACA
TCTCAGGGTACGTAAATCA -> CTCAGGGTACGTAAATCAC
TCTCATTGAAGTTGGGATG -> CTCATTGAAGTTGGGATGC
TCTCCAATCGGCGAGAATG -> CTCCAATCGGCGAGAATGG
TCTCCATTTCTGGTAATGG -> CTCCATTTCTGGTAATGGG
TCTCCTTACGATATTGTTA -> CTCCTTACGATATTGTTAG
TCTCGGAGAAATCAATACA -> CTCGGAGAAATCAATACAG
TCTCTATGTGAGGTCGCGA -> CTCTATGTGAGGTCGCGAC
TCTGAGCGACGCATTGTAA -> CTGAGCGACGCATTGTAAT
TCTGAGGAAGTTGTCTCGG -> CTGAGGAAGTTGTCTCGGA
TCTGCGGATCCCCCACAAG -> CTGCGGATCCCCCACAAGA
TCTGCGTAGGTCCAGCCCC -> CTGCGTAGGTCCAGCCCCG
TCTGGGCTTAGAGGCTTTC -> CTGGGCTTAGAGGCTTTCA
TCTGGGGTAGCGCTTACCG -> CTGGGGTAGCGCTTACCGT
TCTGGTAATGGGCGCGGTG -> CTGGTAATGGGCGCGGTGA
TCTGTACGCTGAGTCAAAG -> CTGTACGCTGAGTCAAAGC
TCTGTTGTGCAGGATAAGC -> CTGTTGTGCAGGATAAGCT
TCTGTTTCAGACCCCCACT -> CTGTTTCAGACCCCCACTT
TCTTAGGGGTACATTCGGT -> CTTAGGGGTACATTCGGTT
TCTTAGTGTAGTATTACCT -> CTTAGTGTAGTATTACCTG
TCTTCAAGAGTAAAGATCG -> CTTCAAGAGTAAAGATCGC
TCTTCGGGACCTATTTACT -> CTTCGGGACCTATTTACTA
TCTTGAGCGTGCTAAAGCC -> CTTGAGCGTGCTAAAGCCT
TGAAGGGTGGCGTTCAGGA -> GAAGGGTGGCGTTCAGGAG
TGAAGGTTAGGTGTACTGC -> GAAGGTTAGGTGTACTGCG
TGAAGTTGGGATGCGTGTC -> GAAGTTGGGATGCGTGTCC
TGACACTTTCGGCCGCGGT -> GACACTTTCGGCCGCGGTC
TGACAGTGTATATAACGGA -> GACAGTGTATATAACGGAC
TGACCGATGTTCAGAAATC -> GACCGATGTTCAGAAATCA
TGACCGCGACCCTTAATAG -> GACCGCGACCCTTAATAGT
TGACCGGTGCGGCTAGCTG -> GACCGGTGCGGCTAGCTGG
TGACGACCTTTTGAAGGTT -> GACGACCTTTTGAAGGTTA
TGACTAATGAGGATGAGCC -> GACTAATGAGGATGAGCCA
TGAGAAAACTCTTAGGGGT -> GAGAAAACTCTTAGGGGTA
TGAGAGGATCCGGACTTTG -> GAGAGGATCCGGACTTTGT
TGAGAGGGTCTGAGGAAGT -> GAGAGGGTCTGAGGAAGTT
TGAGCCATATATTCAACCG -> GAGCCATATATTCAACCGA
TGAGCCCGCCTACGCCCAT -> GAGCCCGCCTACGCCCATG
TGAGCGACGCATTGTAATG -> GAGCGACGCATTGTAATGC
TGAGCGTGCTAAAGCCTTT -> GAGCGTGCTAAAGCCTTTA
TGAGGAAGTTGTCTCGGAG -> GAGGAAGTTGTCTCGGAGA
TGAGGAATGCGAACAAACA -> GAGGAATGCGAACAAACAA
TGAGGATGAGCCATATATT -> GAGGATGAGCCATATATTC
TGAGGCGTAATGGAAGCCA -> GAGGCGTAATGGAAGCCAG
TGAGGTCGCGACACCTGTC -> GAGGTCGCGACACCTGTCG
TGAGTCAAAGCGAATGATG -> GAGTCAAAGCGAATGATGG
TGAGTGGAAACCGCAGAGT -> GAGTGGAAACCGCAGAGTT
TGATACCCCGTTGTGCGCC -> GATACCCCGTTGTGCGCCA
TGATCGTAACCAAGGCATG -> GATCGTAACCAAGGCATGA
TGATCTAGATAGTTTTAAG -> GATCTAGATAGTTTTAAGG
TGATGGTCTGCGTAGGTCC -> GATGGTCTGCGTAGGTCCA
TGATGTAGTCCCTAAACCG -> GATGTAGTCCCTAAACCGC
TGATTCGGATTGTGGATCG -> GATTCGGATTGTGGATCGA
TGATTGCAGAGGACTATTG -> GATTGCAGAGGACTATTGG
TGCAAAGAGCCCACACCGG -> GCAAAGAGCCCACACCGGC
TGCACCTGCACGTGTCATT -> GCACCTGCACGTGTCATTT
TGCACGTGTCATTTAAGTA -> GCACGTGTCATTTAAGTAG
TGCACTAGCGTCTCCTTAC -> GCACTAGCGTCTCCTTACG
TGCAGAGGACTATTGGTCC -> GCAGAGGACTATTGGTCCG
TGCAGGATAAGCTTCCTGT -> GCAGGATAAGCTTCCTGTG
TGCATCATCTGTACGCTGA -> GCATCATCTGTACGCTGAG
TGCCATAAGCTTTTACCCT -> GCCATAAGCTTTTACCCTA
TGCGAACAAACAAGACAGT -> GCGAACAAACAAGACAGTT
TGCGACCGTAATTTGCGCA -> GCGACCGTAATTTGCGCAC
TGCGAGTAGATGATTCGGA -> GCGAGTAGATGATTCGGAT
TGCGCACACATACTTGCAC -> GCGCACACATACTTGCACT
TGCGCACTGGCTCATTTTG -> GCGCACTGGCTCATTTTGA
TGCGCCAACTCTTCGGGAC -> GCGCCAACTCTTCGGGACC
TGCGCTCGGGCTGGCGCAC -> GCGCTCGGGCTGGCGCACA
TGCGGATCCCCCACAAGAT -> GCGGATCCCCCACAAGATT
TGCGGCTAGCTGGCAACGG -> GCGGCTAGCTGGCAACGGA
TGCGTACGTGGGGAGGCGT -> GCGTACGTGGGGAGGCGTT
TGCGTAGGTCCAGCCCCGG -> GCGTAGGTCCAGCCCCGGT
TGCGTATTTAATCTCCATT -> GCGTATTTAATCTCCATTT
TGCGTGTCCCAGCAGGGCG -> GCGTGTCCCAGCAGGGCGA
TGCTAAAGCCTTTAGAGGT -> GCTAAAGCCTTTAGAGGTA
TGCTCGTAAGAAGCGAAGT -> GCTCGTAAGAAGCGAAGTT
TGCTTGACCGGTGCGGCTA -> GCTTGACCGGTGCGGCTAG
TGGAAACCGCAGAGTTCGA -> GGAAACCGCAGAGTTCGAG
TGGAACCGTATAACCTTAA -> GGAACCGTATAACCTTAAG
TGGAAGCCAGAACCGTTCG -> GGAAGCCAGAACCGTTCGG
TGGACGTTTCTGGGGTAGC -> GGACGTTTCTGGGGTAGCG
TGGATCGAGAGAGAACTTC -> GGATCGAGAGAGAACTTCA
TGGCAACGGACCCAAAGAG -> GGCAACGGACCCAAAGAGA
TGGCACATTAAGTTAACCT -> GGCACATTAAGTTAACCTT
TGGCCAGTGGACGTTTCTG -> GGCCAGTGGACGTTTCTGG
TGGCCGCCTCCCATAGACG -> GGCCGCCTCCCATAGACGT
TGGCCGGCTTGGCCGCCTC -> GGCCGGCTTGGCCGCCTCC
TGGCGCACAGTTATCATCG -> GGCGCACAGTTATCATCGT
TGGCGCGATCATTTACTAG -> GGCGCGATCATTTACTAGC
TGGCGTTCAGGAGTCTTGA -> GGCGTTCAGGAGTCTTGAG
TGGCTCATTTTGAGTGGAA -> GGCTCATTTTGAGTGGAAA
TGGGAATCCGGTACGCGGG -> GGGAATCCGGTACGCGGGC
TGGGATGCGTGTCCCAGCA -> GGGATGCGTGTCCCAGCAG
TGGGCGAAACCCTAAACCG -> GGGCGAAACCCTAAACCGC
TGGGCGCGGTGAGAGGATC -> GGGCGCGGTGAGAGGATCC
TGGGCTTAGAGGCTTTCAT -> GGGCTTAGAGGCTTTCATG
TGGGCTTTTAACAGGCCCA -> GGGCTTTTAACAGGCCCAT
TGGGGAGGCGTTTCAGGCA -> GGGGAGGCGTTTCAGGCAA
TGGGGTAGCGCTTACCGTA -> GGGGTAGCGCTTACCGTAA
TGGGTATCTGTTTCAGACC -> GGGTATCTGTTTCAGACCC
TGGTAATGGGCGCGGTGAG -> GGTAATGGGCGCGGTGAGA
TGGTAGCCTGGGTATCTGT -> GGTAGCCTGGGTATCTGTT
TGGTCCGCCGAGTCGCTTT -> GGTCCGCCGAGTCGCTTTT
TGGTCTGCGTAGGTCCAGC -> GGTCTGCGTAGGTCCAGCC
TGGTGAGAAAACTCTTAGG -> GGTGAGAAAACTCTTAGGG
TGGTGTGTAAATTTGACAC -> GGTGTGTAAATTTGACACT
TGGTTAGACGCATCCCGTA -> GGTTAGACGCATCCCGTAT
TGGTTGATACCCCGTTGTG -> GGTTGATACCCCGTTGTGC
TGGTTTGGCACATTAAGTT -> GGTTTGGCACATTAAGTTA
TGTAAATTTGACACTTTCG -> GTAAATTTGACACTTTCGG
TGTAATGCTTGACCGGTGC -> GTAATGCTTGACCGGTGCG
TGTACGCTGAGTCAAAGCG -> GTACGCTGAGTCAAAGCGA
TGTACTAAGCGTGATCTAG -> GTACTAAGCGTGATCTAGA
TGTACTGCGTACGTGGGGA -> GTACTGCGTACGTGGGGAG
TGTAGGATATTTTAGGACC -> GTAGGATATTTTAGGACCC
TGTAGTATTACCTGGTGAG -> GTAGTATTACCTGGTGAGA
TGTAGTCCCTAAACCGCTC -> GTAGTCCCTAAACCGCTCG
TGTATATAACGGACCGCTG -> GTATATAACGGACCGCTGG
TGTCACACAGGGTGTCGCC -> GTCACACAGGGTGTCGCCA
TGTCAGGTCACCATACCCA -> GTCAGGTCACCATACCCAG
TGTCATTTAAGTAGGAAGA -> GTCATTTAAGTAGGAAGAA
TGTCCCAGCAGGGCGAGGT -> GTCCCAGCAGGGCGAGGTC
TGTCGCCAGTATTAGTGTC -> GTCGCCAGTATTAGTGTCA
TGTCGGGAGTTTGTGCACC -> GTCGGGAGTTTGTGCACCT
TGTCTACGTTAGGCATTTA -> GTCTACGTTAGGCATTTAC
TGTCTCGGAGAAATCAATA -> GTCTCGGAGAAATCAATAC
TGTGAGGTCGCGACACCTG -> GTGAGGTCGCGACACCTGT
TGTGCACCTGCACGTGTCA -> GTGCACCTGCACGTGTCAT
TGTGCAGGATAAGCTTCCT -> GTGCAGGATAAGCTTCCTG
TGTGCGCCAACTCTTCGGG -> GTGCGCCAACTCTTCGGGA
TGTGGATCGAGAGAGAACT -> GTGGATCGAGAGAGAACTT
TGTGGTTAGACGCATCCCG -> GTGGTTAGACGCATCCCGT
TGTGTAAATTTGACACTTT -> GTGTAAATTTGACACTTTC
TGTGTCACACAGGGTGTCG -> GTGTCACACAGGGTGTCGC
TGTTAAGACTAACGAGTTA -> GTTAAGACTAACGAGTTAC
TGTTAGAAATCAATACAGC -> GTTAGAAATCAATACAGCA
TGTTCAGAAATCAATACAG -> GTTCAGAAATCAATACAGC
TGTTCCTAAGTCTCACCCG -> GTTCCTAAGTCTCACCCGC
TGTTCTACACGAAGTAAGT -> GTTCTACACGAAGTAAGTC
TGTTGTGCAGGATAAGCTT -> GTTGTGCAGGATAAGCTTC
TGTTTCAGACCCCCACTTC -> GTTTCAGACCCCCACTTCG
TTAACAGCTGGCCAGTGGA -> TAACAGCTGGCCAGTGGAC
TTAACAGGCCCATACCGGG -> TAACAGGCCCATACCGGGA
TTAACCTTCCAGGACACCA -> TAACCTTCCAGGACACCAG
TTAAGACGGTTTTGTTAAG -> TAAGACGGTTTTGTTAAGA
TTAAGACTAACGAGTTACC -> TAAGACTAACGAGTTACCC
TTAAGGAGTGGAACCGTAT -> TAAGGAGTGGAACCGTATA
TTAAGTACCGGGCTCAAAT -> TAAGTACCGGGCTCAAATT
TTAAGTAGGAAGAAATCAA -> TAAGTAGGAAGAAATCAAT
TTAAGTTAACCTTCCAGGA -> TAAGTTAACCTTCCAGGAC
TTAATAGTAAGAGTCAGCT -> TAATAGTAAGAGTCAGCTA
TTAATCTCCATTTCTGGTA -> TAATCTCCATTTCTGGTAA
TTACCCATATTAGAAGTGC -> TACCCATATTAGAAGTGCA
TTACCCCCCGCGATTTGAC -> TACCCCCCGCGATTTGACT
TTACCCTAGGAATTAGTGT -> TACCCTAGGAATTAGTGTC
TTACCGTAAACTCTGTTGT -> TACCGTAAACTCTGTTGTG
TTACCTGGTGAGAAAACTC -> TACCTGGTGAGAAAACTCT
TTACGATATTGTTAGAAAT -> TACGATATTGTTAGAAATC
TTACTAAGGTCACGCTATG -> TACTAAGGTCACGCTATGC
TTACTAGCCCCGGGTAACC -> TACTAGCCCCGGGTAACCG
TTAGAAAAACTCTTAGTGT -> TAGAAAAACTCTTAGTGTA
TTAGAAATCAATACAGCAA -> TAGAAATCAATACAGCAAC
TTAGAACTATAATCTATGT -> TAGAACTATAATCTATGTG
TTAGAAGTGCATCATCTGT -> TAGAAGTGCATCATCTGTA
TTAGACATCGCGTTCCATA -> TAGACATCGCGTTCCATAA
TTAGACGCATCCCGTATCC -> TAGACGCATCCCGTATCCG
TTAGACTCTCATTGAAGTT -> TAGACTCTCATTGAAGTTG
TTAGAGGCTTTCATGATTG -> TAGAGGCTTTCATGATTGC
TTAGAGGTACGCGAGGCGT -> TAGAGGTACGCGAGGCGTG
TTAGGACCCCCGCGCGATA -> TAGGACCCCCGCGCGATAT
TTAGGCATTTACCCCCCGC -> TAGGCATTTACCCCCCGCG
TTAGGGGTACATTCGGTTT -> TAGGGGTACATTCGGTTTA
TTAGGTGTACTGCGTACGT -> TAGGTGTACTGCGTACGTG
TTAGTGTAGTATTACCTGG -> TAGTGTAGTATTACCTGGT
TTAGTGTCAGGTCACCATA -> TAGTGTCAGGTCACCATAC
TTAGTGTCTACGTTAGGCA -> TAGTGTCTACGTTAGGCAT
TTATCATCGTTATCTCCAA -> TATCATCGTTATCTCCAAT
TTATCTCCAATCGGCGAGA -> TATCTCCAATCGGCGAGAA
TTATCTGGGCTTAGAGGCT -> TATCTGGGCTTAGAGGCTT
TTATGAGAGGGTCTGAGGA -> TATGAGAGGGTCTGAGGAA
TTCAAATCGGGAAATACGG -> TCAAATCGGGAAATACGGT
TTCAACCGATGAAGGGTGG -> TCAACCGATGAAGGGTGGC
TTCAAGAGTAAAGATCGCG -> TCAAGAGTAAAGATCGCGA
TTCAATAGTGATCGTAACC -> TCAATAGTGATCGTAACCA
TTCAGAAATCAATACAGCA -> TCAGAAATCAATACAGCAA
TTCAGACCCCCACTTCGGG -> TCAGACCCCCACTTCGGGT
TTCAGCGAAACAGCCGAAG -> TCAGCGAAACAGCCGAAGG
TTCAGGAGTCTTGAGCGTG -> TCAGGAGTCTTGAGCGTGC
TTCAGGCAATTACAAATGT -> TCAGGCAATTACAAATGTG
TTCATGATTGCAGAGGACT -> TCATGATTGCAGAGGACTA
TTCCAACGCCATTGACGAC -> TCCAACGCCATTGACGACC
TTCCAGGACACCAGATGCG -> TCCAGGACACCAGATGCGA
TTCCATAATGCGTATTTAA -> TCCATAATGCGTATTTAAT
TTCCGTCCTTTCCAACGCC -> TCCGTCCTTTCCAACGCCA
TTCCTAAGTCTCACCCGCC -> TCCTAAGTCTCACCCGCCG
TTCCTGTGGTTAGACGCAT -> TCCTGTGGTTAGACGCATC
TTCGAGCGCTCAATAGCGG -> TCGAGCGCTCAATAGCGGC
TTCGCAGGGAATAACGCCT -> TCGCAGGGAATAACGCCTA
TTCGCGGTGACCGCGACCC -> TCGCGGTGACCGCGACCCT
TTCGGATTGTGGATCGAGA -> TCGGATTGTGGATCGAGAG
TTCGGCCGCGGTCTCAGGG -> TCGGCCGCGGTCTCAGGGT
TTCGGCTAGTGGTAGCCTG -> TCGGCTAGTGGTAGCCTGG
TTCGGGACCTATTTACTAA -> TCGGGACCTATTTACTAAG
TTCGGGTCGCTCGATGCTC -> TCGGGTCGCTCGATGCTCG
TTCGGGTGCAAAGAGCCCA -> TCGGGTGCAAAGAGCCCAC
TTCGGTTTATGAGAGGGTC -> TCGGTTTATGAGAGGGTCT
TTCGTATCTCTATGTGAGG -> TCGTATCTCTATGTGAGGT
TTCTACACGAAGTAAGTCG -> TCTACACGAAGTAAGTCGC
TTCTGAGCGACGCATTGTA -> TCTGAGCGACGCATTGTAA
TTCTGGGGTAGCGCTTACC -> TCTGGGGTAGCGCTTACCG
TTCTGGTAATGGGCGCGGT -> TCTGGTAATGGGCGCGGTG
TTCTTCAAGAGTAAAGATC -> TCTTCAAGAGTAAAGATCG
TTGAAGGTTAGGTGTACTG -> TGAAGGTTAGGTGTACTGC
TTGAAGTTGGGATGCGTGT -> TGAAGTTGGGATGCGTGTC
TTGACACTTTCGGCCGCGG -> TGACACTTTCGGCCGCGGT
TTGACCGGTGCGGCTAGCT -> TGACCGGTGCGGCTAGCTG
TTGACGACCTTTTGAAGGT -> TGACGACCTTTTGAAGGTT
TTGACTAATGAGGATGAGC -> TGACTAATGAGGATGAGCC
TTGAGCGTGCTAAAGCCTT -> TGAGCGTGCTAAAGCCTTT
TTGAGTGGAAACCGCAGAG -> TGAGTGGAAACCGCAGAGT
TTGATACCCCGTTGTGCGC -> TGATACCCCGTTGTGCGCC
TTGCACTAGCGTCTCCTTA -> TGCACTAGCGTCTCCTTAC
TTGCAGAGGACTATTGGTC -> TGCAGAGGACTATTGGTCC
TTGCGCACACATACTTGCA -> TGCGCACACATACTTGCAC
TTGCGCACTGGCTCATTTT -> TGCGCACTGGCTCATTTTG
TTGGCACATTAAGTTAACC -> TGGCACATTAAGTTAACCT
TTGGCCGCCTCCCATAGAC -> TGGCCGCCTCCCATAGACG
TTGGCCGGCTTGGCCGCCT -> TGGCCGGCTTGGCCGCCTC
TTGGCGCGATCATTTACTA -> TGGCGCGATCATTTACTAG
TTGGGATGCGTGTCCCAGC -> TGGGATGCGTGTCCCAGCA
TTGGGCTTTTAACAGGCCC -> TGGGCTTTTAACAGGCCCA
TTGGTCCGCCGAGTCGCTT -> TGGTCCGCCGAGTCGCTTT
TTGTAATGCTTGACCGGTG -> TGTAATGCTTGACCGGTGC
TTGTACTAAGCGTGATCTA -> TGTACTAAGCGTGATCTAG
TTGTAGGATATTTTAGGAC -> TGTAGGATATTTTAGGACC
TTGTCTCGGAGAAATCAAT -> TGTCTCGGAGAAATCAATA
TTGTGCACCTGCACGTGTC -> TGTGCACCTGCACGTGTCA
TTGTGCAGGATAAGCTTCC -> TGTGCAGGATAAGCTTCCT
TTGTGCGCCAACTCTTCGG -> TGTGCGCCAACTCTTCGGG
TTGTGGATCGAGAGAGAAC -> TGTGGATCGAGAGAGAACT
TTGTTAAGACTAACGAGTT -> TGTTAAGACTAACGAGTTA
TTGTTAGAAATCAATACAG -> TGTTAGAAATCAATACAGC
TTTAACAGGCCCATACCGG -> TTAACAGGCCCATACCGGG
TTTAAGGAGTGGAACCGTA -> TTAAGGAGTGGAACCGTAT
TTTAAGTAGGAAGAAATCA -> TTAAGTAGGAAGAAATCAA
TTTAATCTCCATTTCTGGT -> TTAATCTCCATTTCTGGTA
TTTACCCCCCGCGATTTGA -> TTACCCCCCGCGATTTGAC
TTTACCCTAGGAATTAGTG -> TTACCCTAGGAATTAGTGT
TTTACTAAGGTCACGCTAT -> TTACTAAGGTCACGCTATG
TTTACTAGCCCCGGGTAAC -> TTACTAGCCCCGGGTAACC
TTTAGACTCTCATTGAAGT -> TTAGACTCTCATTGAAGTT
TTTAGAGGTACGCGAGGCG -> TTAGAGGTACGCGAGGCGT
TTTAGGACCCCCGCGCGAT -> TTAGGACCCCCGCGCGATA
TTTATGAGAGGGTCTGAGG -> TTATGAGAGGGTCTGAGGA
TTTCAATAGTGATCGTAAC -> TTCAATAGTGATCGTAACC
TTTCAGACCCCCACTTCGG -> TTCAGACCCCCACTTCGGG
TTTCAGGCAATTACAAATG -> TTCAGGCAATTACAAATGT
TTTCATGATTGCAGAGGAC -> TTCATGATTGCAGAGGACT
TTTCCAACGCCATTGACGA -> TTCCAACGCCATTGACGAC
TTTCGCAGGGAATAACGCC -> TTCGCAGGGAATAACGCCT
TTTCGCGGTGACCGCGACC -> TTCGCGGTGACCGCGACCC
TTTCGGCCGCGGTCTCAGG -> TTCGGCCGCGGTCTCAGGG
TTTCTGGGGTAGCGCTTAC -> TTCTGGGGTAGCGCTTACC
TTTCTGGTAATGGGCGCGG -> TTCTGGTAATGGGCGCGGT
TTTGAAGGTTAGGTGTACT -> TTGAAGGTTAGGTGTACTG
TTTGACACTTTCGGCCGCG -> TTGACACTTTCGGCCGCGG
TTTGACTAATGAGGATGAG -> TTGACTAATGAGGATGAGC
TTTGAGTGGAAACCGCAGA -> TTGAGTGGAAACCGCAGAG
TTTGCGCACACATACTTGC -> TTGCGCACACATACTTGCA
TTTGGCACATTAAGTTAAC -> TTGGCACATTAAGTTAACC
TTTGTAGGATATTTTAGGA -> TTGTAGGATATTTTAGGAC
TTTGTGCACCTGCACGTGT -> TTGTGCACCTGCACGTGTC
TTTGTTAAGACTAACGAGT -> TTGTTAAGACTAACGAGTT
TTTTAACAGGCCCATACCG -> TTTAACAGGCCCATACCGG
TTTTAAGGAGTGGAACCGT -> TTTAAGGAGTGGAACCGTA
TTTTACCCTAGGAATTAGT -> TTTACCCTAGGAATTAGTG
TTTTAGGACCCCCGCGCGA -> TTTAGGACCCCCGCGCGAT
TTTTCGCAGGGAATAACGC -> TTTCGCAGGGAATAACGCC
TTTTGAAGGTTAGGTGTAC -> TTTGAAGGTTAGGTGTACT
TTTTGAGTGGAAACCGCAG -> TTTGAGTGGAAACCGCAGA
TTTTGTTAAGACTAACGAG -> TTTGTTAAGACTAACGAGT
